"Day","Home","Visitor","Hscore","Vscore","Neutral","Diff"
1,1462,1324,101,49,0,52
1,1275,1315,81,67,0,14
1,1139,1444,66,62,0,4
1,1423,1441,76,98,0,-22
1,1243,1179,70,80,0,-10
1,1268,1330,85,67,0,18
1,1344,1193,97,56,0,41
1,1133,1405,61,59,0,2
1,1426,1329,68,75,0,-7
1,1257,1191,79,44,0,35
1,1276,1132,96,82,0,14
1,1365,1226,62,49,0,13
1,1334,1415,66,60,0,6
1,1297,1123,74,73,0,1
1,1314,1102,79,60,0,19
1,1246,1287,81,45,0,36
1,1281,1331,91,64,0,27
1,1102,1227,61,65,0,-4
1,1375,1102,68,66,0,2
1,1385,1389,76,75,0,1
1,1277,1185,83,67,0,16
1,1160,1102,84,61,0,23
1,1278,1453,99,69,0,30
1,1231,1399,89,59,0,30
1,1104,1102,81,57,0,24
1,1400,1410,91,55,0,36
1,1210,1209,120,123,0,-3
1,1458,1183,77,67,0,10
1,1337,1414,86,72,0,14
1,1361,1417,73,58,0,15
1,1424,1286,78,91,0,-13
1,1425,1465,95,87,0,8
1,1258,1381,85,83,0,2
1,1101,1102,70,47,1,23
1,1303,1122,66,72,1,-6
1,1345,1251,77,64,1,13
1,1102,1155,42,53,1,-11
1,1130,1437,67,76,1,-9
1,1387,1188,89,52,0,37
1,1305,1295,62,48,0,14
1,1348,1113,88,94,0,-6
1,1102,1325,61,84,0,-23
1,1333,1143,71,63,0,8
1,1326,1229,94,67,0,27
1,1438,1406,89,54,0,35
1,1339,1370,72,84,0,-12
1,1272,1388,73,56,1,17
1,1320,1443,87,93,1,-6
1,1355,1452,71,79,1,-8
1,1433,1429,85,69,1,16
1,1298,1203,78,71,0,7
1,1288,1291,55,62,0,-7
1,1353,1357,86,63,0,23
1,1439,1347,77,62,0,15
1,1304,1270,102,55,0,47
1,1114,1341,71,66,0,5
1,1102,1102,61,81,0,-20
1,1222,1249,89,45,0,44
1,1228,1102,122,60,0,62
1,1412,1108,99,50,0,49
1,1448,1175,111,51,0,60
1,1234,1102,97,67,0,30
1,1346,1102,84,66,0,18
1,1207,1420,70,62,0,8
1,1316,1184,67,80,0,-13
1,1403,1102,101,58,0,43
1,1195,1102,65,56,0,9
1,1338,1384,70,80,0,-10
1,1236,1368,67,63,0,4
1,1172,1219,82,73,0,9
1,1116,1102,142,62,0,80
1,1395,1223,69,45,0,24
1,1163,1102,102,75,0,27
1,1374,1358,97,67,0,30
1,1213,1212,69,53,0,16
1,1301,1149,95,61,0,34
1,1450,1411,56,52,0,4
1,1413,1311,93,101,0,-8
1,1266,1115,99,57,0,42
1,1262,1362,76,68,0,8
2,1462,1133,51,50,0,1
2,1324,1405,53,80,0,-27
2,1242,1211,90,102,0,-12
2,1385,1247,82,65,0,17
2,1386,1120,91,96,0,-5
2,1292,1303,59,60,1,-1
2,1122,1102,67,66,1,1
2,1272,1443,69,75,1,-6
2,1452,1433,78,66,1,12
2,1388,1320,66,64,1,2
2,1355,1429,83,59,1,24
2,1102,1251,73,84,1,-11
2,1155,1345,81,70,1,11
2,1304,1305,66,69,0,-3
2,1348,1130,64,69,1,-5
2,1113,1437,74,83,1,-9
2,1261,1188,94,81,0,13
2,1228,1102,97,38,0,59
2,1406,1362,68,79,0,-11
2,1380,1102,78,85,0,-7
2,1125,1224,95,78,0,17
2,1317,1102,116,62,0,54
2,1140,1309,86,61,0,25
2,1299,1325,72,84,0,-12
3,1211,1120,90,67,0,23
3,1438,1362,60,61,0,-1
3,1462,1405,76,73,0,3
3,1441,1407,64,66,0,-2
3,1228,1325,77,75,0,2
3,1102,1102,60,50,0,10
3,1102,1179,53,69,0,-16
3,1206,1125,67,77,0,-10
3,1242,1386,94,72,0,22
3,1324,1133,60,74,0,-14
3,1417,1337,107,98,0,9
3,1222,1129,68,58,0,10
3,1365,1413,66,63,0,3
3,1257,1371,71,70,0,1
3,1389,1247,62,51,0,11
3,1138,1406,74,65,0,9
3,1361,1414,77,58,0,19
3,1266,1183,75,50,0,25
3,1422,1114,77,70,0,7
3,1435,1434,77,71,0,6
3,1256,1426,76,71,0,5
3,1210,1273,73,83,0,-10
3,1243,1160,58,76,0,-18
3,1287,1350,64,82,0,-18
3,1102,1292,57,43,1,14
3,1122,1101,72,80,1,-8
3,1452,1443,70,64,1,6
3,1320,1429,71,82,1,-11
3,1388,1355,72,59,1,13
3,1272,1433,59,70,1,-11
3,1267,1117,70,56,0,14
3,1241,1102,73,83,0,-10
3,1341,1191,64,61,0,3
3,1403,1358,84,52,0,32
3,1230,1349,53,68,0,-15
3,1408,1249,66,57,0,9
3,1149,1184,50,60,0,-10
3,1268,1298,82,52,0,30
3,1393,1136,85,84,0,1
3,1421,1423,68,76,0,-8
3,1102,1102,44,74,0,-30
3,1112,1212,74,55,0,19
3,1234,1380,103,76,0,27
3,1301,1316,86,51,0,35
3,1311,1226,70,51,0,19
3,1448,1255,71,60,0,11
3,1353,1102,96,75,0,21
3,1163,1216,69,57,0,12
3,1458,1115,92,58,0,34
3,1119,1148,79,57,0,22
4,1304,1295,79,57,0,22
4,1338,1180,83,74,0,9
4,1423,1407,73,50,0,23
4,1387,1261,85,81,0,4
4,1410,1427,81,64,0,17
4,1413,1226,70,61,0,9
4,1336,1440,86,65,0,21
4,1102,1169,66,61,0,5
4,1425,1285,76,62,0,14
4,1378,1348,68,84,0,-16
4,1282,1102,66,71,0,-5
4,1116,1317,69,54,0,15
4,1278,1258,88,73,0,15
4,1330,1102,86,78,0,8
4,1277,1323,80,70,0,10
4,1140,1430,82,60,0,22
4,1450,1102,71,68,0,3
4,1251,1376,78,62,1,16
4,1395,1409,70,65,1,5
4,1437,1439,73,81,0,-8
4,1124,1418,112,82,0,30
4,1227,1141,74,72,0,2
4,1101,1303,70,58,0,12
4,1132,1102,101,78,0,23
4,1202,1367,91,63,0,28
4,1239,1379,66,51,0,15
4,1181,1164,81,71,0,10
4,1229,1262,82,72,0,10
4,1224,1206,70,84,0,-14
4,1291,1298,67,73,0,-6
4,1412,1368,84,59,0,25
4,1384,1420,65,80,0,-15
4,1102,1402,63,75,0,-12
4,1138,1119,74,78,0,-4
4,1102,1426,71,80,0,-9
4,1421,1441,81,83,0,-2
4,1461,1102,97,61,0,36
4,1189,1219,76,75,0,1
4,1249,1252,73,76,0,-3
4,1365,1311,73,57,0,16
4,1347,1102,54,57,0,-3
4,1329,1411,85,65,0,20
5,1246,1350,64,76,0,-12
5,1124,1449,86,52,0,34
5,1353,1220,70,56,0,14
5,1166,1295,69,58,0,11
5,1370,1102,63,45,0,18
5,1375,1102,73,77,0,-4
5,1222,1403,64,53,0,11
5,1362,1348,71,84,0,-13
5,1276,1324,81,71,0,10
5,1378,1439,58,76,0,-18
5,1409,1376,58,69,1,-11
5,1395,1251,56,52,1,4
5,1287,1117,69,61,0,8
5,1235,1115,80,63,0,17
5,1408,1252,68,66,0,2
5,1256,1102,91,77,0,14
5,1358,1129,55,86,0,-31
5,1208,1102,85,75,0,10
5,1268,1291,79,61,0,18
5,1102,1309,82,53,0,29
5,1359,1102,76,78,0,-2
5,1113,1223,100,77,0,23
5,1326,1262,74,64,0,10
5,1274,1316,77,59,0,18
5,1257,1341,86,64,0,22
5,1241,1347,67,59,0,8
6,1172,1400,76,78,0,-2
6,1344,1231,58,79,0,-21
6,1182,1114,66,76,0,-10
6,1169,1370,76,65,0,11
6,1102,1132,76,78,0,-2
6,1130,1385,93,97,0,-4
6,1399,1151,54,62,0,-8
6,1416,1120,63,55,0,8
6,1462,1184,99,96,0,3
6,1273,1209,86,69,0,17
6,1424,1314,51,78,0,-27
6,1243,1282,62,58,0,4
6,1278,1258,67,64,0,3
6,1102,1402,68,51,0,17
6,1104,1390,64,82,0,-18
6,1305,1334,70,58,0,12
6,1371,1233,86,64,0,22
6,1220,1102,73,58,0,15
6,1374,1102,91,54,0,37
6,1261,1368,96,43,0,53
6,1143,1311,60,49,0,11
6,1461,1411,74,76,0,-2
7,1140,1425,53,79,0,-26
7,1345,1324,93,50,0,43
7,1166,1303,94,67,0,27
7,1458,1453,82,42,0,40
7,1257,1443,75,54,0,21
7,1405,1156,70,61,0,9
7,1227,1434,66,50,0,16
7,1266,1329,62,70,0,-8
7,1198,1141,96,76,0,20
7,1181,1277,69,75,0,-6
7,1304,1102,76,69,0,7
7,1242,1246,65,62,0,3
7,1231,1400,44,66,1,-22
7,1390,1314,63,67,1,-4
7,1344,1172,63,62,1,1
7,1104,1424,86,74,1,12
7,1173,1183,66,63,0,3
7,1449,1415,42,57,0,-15
7,1422,1457,67,75,0,-8
7,1438,1384,76,51,0,25
7,1306,1136,85,93,0,-8
7,1207,1298,71,78,0,-7
7,1149,1102,63,70,0,-7
7,1203,1214,78,82,0,-4
7,1388,1311,73,50,0,23
7,1437,1216,87,53,0,34
7,1389,1392,82,68,0,14
7,1440,1255,84,71,0,13
7,1213,1290,88,49,0,39
8,1422,1182,68,81,0,-13
8,1326,1287,77,44,0,33
8,1334,1286,74,70,0,4
8,1336,1433,72,69,0,3
8,1102,1188,53,73,0,-20
8,1462,1399,79,48,0,31
8,1455,1331,85,80,0,5
8,1348,1371,76,63,0,13
8,1211,1452,87,82,0,5
8,1276,1123,84,65,0,19
8,1235,1355,68,71,0,-3
8,1102,1102,73,66,0,7
8,1292,1293,78,61,0,17
8,1102,1102,79,87,0,-8
8,1346,1180,48,66,0,-18
8,1272,1117,83,54,0,29
8,1102,1191,93,87,0,6
8,1305,1362,60,85,0,-25
8,1281,1332,83,75,0,8
8,1116,1426,72,60,0,12
8,1450,1333,59,55,0,4
8,1124,1228,82,69,0,13
8,1390,1231,63,79,1,-16
8,1314,1400,67,69,1,-2
8,1104,1344,88,71,1,17
8,1424,1172,73,77,1,-4
8,1140,1385,74,68,0,6
8,1469,1315,74,73,0,1
8,1196,1119,76,69,0,7
8,1378,1195,76,57,0,19
8,1153,1252,67,55,0,12
8,1367,1184,78,95,0,-17
8,1155,1102,75,38,0,37
8,1193,1216,61,66,0,-5
8,1239,1342,78,65,0,13
8,1412,1244,73,48,0,25
8,1102,1330,66,80,0,-14
8,1410,1102,62,59,0,3
8,1309,1418,63,66,0,-3
8,1465,1368,80,81,0,-1
8,1199,1316,86,58,0,28
8,1374,1223,102,75,0,27
8,1461,1230,94,83,0,11
8,1321,1115,92,49,0,43
9,1183,1102,78,56,0,22
9,1428,1449,76,62,0,14
9,1297,1399,74,65,0,9
9,1460,1267,64,80,0,-16
9,1425,1163,58,61,0,-3
9,1393,1310,75,45,0,30
9,1256,1419,78,62,0,16
9,1439,1440,64,57,0,7
9,1234,1442,99,58,0,41
9,1417,1370,78,52,0,26
9,1179,1303,87,66,0,21
9,1328,1427,105,66,0,39
9,1170,1225,77,55,0,22
9,1381,1285,64,63,0,1
9,1130,1196,70,90,0,-20
9,1143,1113,62,70,0,-8
9,1180,1346,70,58,0,12
9,1114,1457,75,80,0,-5
9,1301,1262,90,59,0,31
9,1251,1384,78,62,0,16
9,1154,1102,78,70,0,8
9,1395,1102,74,68,0,6
9,1388,1411,82,70,0,12
10,1268,1389,90,57,0,33
10,1409,1426,79,64,0,15
10,1277,1178,83,76,0,7
10,1150,1209,65,76,0,-11
10,1438,1245,71,64,0,7
10,1185,1405,74,91,0,-17
10,1266,1458,67,65,0,2
10,1345,1434,68,61,0,7
10,1198,1102,74,70,0,4
10,1102,1317,69,63,0,6
10,1258,1253,85,61,0,24
10,1278,1315,76,67,0,9
10,1403,1407,80,46,0,34
10,1120,1375,90,81,0,9
10,1371,1332,70,83,0,-13
10,1133,1355,84,88,0,-4
10,1142,1362,60,88,0,-28
10,1392,1193,72,69,0,3
10,1465,1368,83,66,0,17
10,1166,1244,93,58,0,35
10,1216,1102,80,65,0,15
10,1208,1239,98,65,0,33
10,1181,1468,76,54,0,22
10,1372,1270,86,76,0,10
10,1274,1391,82,60,0,22
10,1272,1146,85,68,0,17
11,1321,1102,111,66,0,45
11,1112,1102,70,67,0,3
11,1170,1225,73,57,0,16
11,1123,1227,68,66,0,2
11,1381,1285,75,74,0,1
11,1173,1374,64,66,0,-2
11,1453,1183,91,93,0,-2
11,1188,1303,63,65,0,-2
11,1242,1295,65,61,0,4
11,1460,1275,71,47,0,24
11,1220,1233,74,82,0,-8
11,1125,1359,83,96,0,-13
11,1222,1376,77,67,0,10
11,1393,1351,87,52,0,35
11,1338,1102,89,59,0,30
11,1329,1324,84,71,0,13
11,1243,1424,58,68,0,-10
11,1429,1140,64,67,0,-3
11,1339,1340,86,73,0,13
11,1102,1202,57,81,0,-24
11,1293,1229,76,65,0,11
11,1187,1347,63,50,0,13
11,1219,1316,85,74,0,11
11,1421,1102,77,56,0,21
11,1433,1291,60,42,0,18
11,1127,1265,65,68,0,-3
11,1402,1230,72,64,0,8
11,1102,1249,59,44,0,15
11,1344,1102,79,67,0,12
11,1116,1252,86,50,0,36
11,1367,1204,69,72,0,-3
11,1101,1102,69,48,0,21
11,1223,1349,64,86,0,-22
11,1387,1115,107,54,0,53
11,1102,1164,85,69,0,16
12,1441,1399,76,75,0,1
12,1400,1437,64,68,0,-4
12,1455,1281,62,72,0,-10
12,1325,1156,101,46,0,55
12,1153,1462,69,77,0,-8
12,1412,1407,77,55,0,22
12,1176,1415,63,83,0,-20
12,1442,1141,73,79,0,-6
12,1395,1328,78,82,0,-4
12,1102,1410,81,68,0,13
12,1333,1461,73,76,0,-3
12,1276,1416,80,58,0,22
12,1207,1452,71,80,0,-9
12,1361,1337,65,60,0,5
12,1253,1370,80,75,0,5
12,1210,1246,79,62,0,17
12,1261,1256,86,55,0,31
12,1132,1138,86,78,0,8
12,1277,1444,79,61,0,18
12,1323,1178,78,70,0,8
12,1417,1143,76,56,0,20
12,1336,1371,92,98,0,-6
12,1403,1212,81,40,0,41
12,1180,1164,69,54,0,15
12,1196,1391,86,40,0,46
12,1346,1306,64,58,0,6
12,1385,1392,89,66,0,23
12,1114,1146,86,83,0,3
12,1102,1419,83,92,0,-9
12,1265,1127,64,60,0,4
12,1119,1247,63,59,0,4
12,1224,1468,63,84,0,-21
12,1443,1290,96,69,0,27
12,1299,1390,46,78,0,-32
13,1187,1423,88,78,0,10
13,1184,1287,71,68,0,3
13,1292,1151,70,80,0,-10
13,1364,1258,69,58,0,11
13,1112,1319,96,53,0,43
13,1350,1459,77,72,0,5
13,1420,1203,92,81,0,11
13,1332,1102,69,52,0,17
13,1216,1193,67,54,0,13
13,1150,1102,78,40,0,38
13,1102,1214,76,64,0,12
13,1316,1102,77,79,0,-2
13,1102,1252,82,77,0,5
13,1157,1300,78,71,0,7
14,1274,1345,58,54,0,4
14,1242,1166,73,72,0,1
14,1428,1226,75,59,0,16
14,1397,1160,56,47,0,9
14,1173,1297,66,60,0,6
14,1278,1130,85,80,0,5
14,1102,1123,70,79,0,-9
14,1208,1285,63,50,0,13
14,1385,1351,82,79,0,3
14,1178,1245,66,80,0,-14
14,1125,1398,79,64,0,15
14,1323,1326,85,90,0,-5
14,1234,1314,93,80,0,13
14,1329,1331,83,78,0,5
14,1293,1122,87,57,0,30
14,1439,1336,55,75,0,-20
14,1266,1453,82,68,0,14
14,1353,1393,79,69,0,10
14,1181,1228,68,83,0,-15
14,1388,1431,73,61,0,12
14,1425,1414,91,56,0,35
14,1233,1288,72,83,0,-11
14,1420,1174,76,61,0,15
14,1378,1391,73,62,0,11
14,1371,1447,78,45,0,33
14,1255,1102,77,60,0,17
14,1102,1102,87,94,0,-7
14,1383,1136,82,101,0,-19
14,1291,1384,75,57,0,18
14,1239,1144,78,80,0,-2
14,1207,1164,80,48,0,32
14,1387,1146,88,65,0,23
14,1272,1102,94,57,0,37
14,1102,1238,82,59,0,23
15,1260,1102,88,51,0,37
15,1458,1348,73,62,0,11
15,1155,1268,67,51,0,16
15,1395,1344,70,79,0,-9
15,1153,1202,78,73,0,5
15,1275,1442,67,57,0,10
15,1350,1320,78,68,0,10
15,1102,1267,72,84,0,-12
15,1112,1167,85,60,0,25
15,1191,1183,68,65,0,3
15,1434,1188,80,58,0,22
15,1304,1210,64,75,0,-11
15,1400,1402,74,53,0,21
15,1408,1379,58,38,0,20
15,1462,1328,99,77,0,22
15,1430,1381,71,81,0,-10
15,1417,1360,83,56,0,27
15,1461,1176,83,61,0,22
15,1337,1143,74,62,0,12
15,1140,1129,70,74,0,-4
15,1450,1225,61,58,0,3
15,1142,1365,69,76,0,-7
15,1199,1231,69,67,0,2
15,1321,1338,70,71,0,-1
15,1449,1370,73,41,0,32
15,1276,1405,91,71,0,20
15,1144,1309,79,70,0,9
15,1383,1136,93,91,0,2
15,1102,1102,79,71,0,8
15,1403,1101,51,44,0,7
15,1433,1102,95,59,0,36
15,1220,1392,72,67,0,5
15,1468,1151,68,77,0,-9
15,1419,1249,60,63,0,-3
15,1117,1115,74,75,0,-1
15,1256,1368,78,69,0,9
15,1281,1251,69,60,0,9
15,1252,1102,80,74,0,6
15,1332,1102,87,66,0,21
15,1124,1372,83,52,0,31
16,1102,1315,71,75,0,-4
16,1333,1339,86,87,0,-1
16,1278,1282,90,61,0,29
16,1319,1415,50,74,0,-24
16,1362,1253,107,62,0,45
16,1355,1295,77,75,0,2
16,1113,1361,68,80,0,-12
16,1239,1309,77,70,0,7
16,1187,1316,73,67,0,6
16,1466,1407,57,62,0,-5
16,1164,1422,85,80,0,5
16,1279,1238,80,45,0,35
16,1102,1410,64,68,0,-4
16,1443,1205,86,84,0,2
17,1269,1318,94,79,0,15
17,1371,1385,77,68,0,9
17,1150,1102,57,61,0,-4
17,1264,1351,64,82,0,-18
17,1315,1355,62,74,0,-12
17,1207,1437,63,76,0,-13
17,1242,1303,95,50,0,45
17,1193,1233,42,70,0,-28
17,1172,1204,77,45,0,32
17,1145,1265,81,72,0,9
17,1166,1304,98,74,0,24
17,1174,1203,68,65,0,3
17,1102,1293,70,66,0,4
17,1389,1310,70,54,0,16
17,1243,1454,76,75,0,1
17,1234,1235,105,77,0,28
17,1213,1305,87,77,0,10
17,1295,1102,74,67,0,7
17,1417,1266,69,60,0,9
17,1388,1363,96,61,0,35
17,1452,1317,62,50,0,12
17,1102,1102,90,63,0,27
18,1199,1196,83,71,0,12
18,1405,1282,64,57,0,7
18,1246,1323,63,64,0,-1
18,1102,1173,82,85,0,-3
18,1237,1398,69,66,0,3
18,1397,1153,65,56,0,9
18,1130,1393,63,101,0,-38
18,1180,1247,48,58,0,-10
18,1395,1102,73,55,0,18
18,1444,1178,57,67,0,-10
18,1378,1459,58,56,0,2
18,1379,1375,75,76,0,-1
18,1455,1329,64,67,0,-3
18,1176,1469,70,73,0,-3
18,1167,1225,76,66,0,10
18,1430,1461,88,93,0,-5
18,1102,1412,61,65,0,-4
18,1141,1434,84,79,0,5
18,1272,1120,71,74,0,-3
18,1433,1330,77,54,0,23
18,1183,1442,92,88,0,4
18,1258,1364,81,76,0,5
18,1279,1423,78,58,0,20
18,1140,1428,82,64,0,18
18,1112,1431,69,61,0,8
18,1264,1351,87,77,0,10
18,1295,1315,53,52,0,1
18,1193,1233,67,52,0,15
18,1145,1265,52,56,0,-4
18,1123,1229,82,66,0,16
18,1418,1256,61,56,0,5
18,1208,1359,79,75,0,4
18,1155,1104,64,56,0,8
18,1345,1232,80,68,0,12
18,1449,1332,71,74,0,-3
18,1389,1310,53,49,0,4
18,1281,1228,81,78,0,3
18,1337,1169,84,89,0,-5
18,1355,1102,78,91,0,-13
18,1274,1195,62,66,0,-4
18,1136,1392,81,72,0,9
18,1403,1102,77,57,0,20
18,1408,1115,67,56,0,11
18,1314,1102,73,67,0,6
18,1421,1219,80,67,0,13
18,1338,1205,67,50,0,17
18,1367,1457,77,95,0,-18
18,1102,1441,98,104,0,-6
18,1419,1372,66,55,0,11
18,1328,1102,85,54,0,31
18,1316,1198,80,77,0,3
18,1116,1146,100,75,0,25
18,1252,1125,71,81,0,-10
19,1277,1324,109,91,0,18
19,1132,1460,67,85,0,-18
19,1443,1348,68,65,0,3
19,1318,1269,78,75,0,3
19,1452,1350,87,71,0,16
19,1267,1325,81,67,0,14
19,1245,1297,92,73,0,19
19,1234,1102,106,53,0,53
19,1276,1336,62,58,0,4
19,1444,1454,63,71,0,-8
19,1179,1102,81,53,0,28
19,1227,1260,66,77,0,-11
19,1143,1362,72,70,0,2
19,1349,1307,61,72,0,-11
19,1326,1156,67,61,0,6
19,1142,1363,75,71,0,4
19,1129,1451,70,59,0,11
19,1213,1113,70,71,0,-1
19,1450,1340,69,60,0,9
19,1399,1102,67,73,0,-6
19,1204,1273,75,77,0,-2
19,1207,1385,97,94,0,3
19,1231,1466,87,52,0,35
19,1440,1214,79,64,0,15
19,1367,1457,77,107,0,-30
19,1102,1239,58,60,0,-2
19,1422,1102,64,47,0,17
19,1435,1102,84,41,0,43
19,1164,1420,49,66,0,-17
19,1127,1464,65,79,0,-14
20,1268,1353,60,74,0,-14
20,1287,1184,75,62,0,13
20,1161,1319,91,52,0,39
20,1360,1305,72,79,0,-7
20,1160,1294,81,45,0,36
20,1166,1266,84,89,0,-5
20,1102,1456,84,85,0,-1
20,1261,1358,88,66,0,22
20,1347,1255,67,66,0,1
20,1279,1146,68,54,0,14
21,1103,1382,74,81,0,-7
21,1229,1152,91,62,0,29
21,1169,1390,71,82,0,-11
21,1275,1138,62,90,0,-28
21,1459,1157,88,77,0,11
21,1439,1155,66,60,0,6
21,1172,1150,52,63,0,-11
21,1228,1278,92,65,0,27
21,1409,1455,65,69,0,-4
21,1433,1441,93,68,0,25
21,1397,1111,79,38,0,41
21,1102,1430,75,67,0,8
21,1191,1369,66,63,0,3
21,1284,1220,88,96,0,-8
21,1387,1232,78,59,0,19
21,1199,1210,74,61,0,13
21,1104,1202,83,80,0,3
21,1235,1243,65,74,0,-9
21,1388,1186,80,75,0,5
21,1458,1260,77,63,0,14
21,1349,1223,90,79,0,11
21,1347,1255,62,53,0,9
21,1120,1411,80,63,0,17
21,1148,1383,86,91,0,-5
21,1401,1368,69,52,0,17
21,1251,1354,82,52,0,30
21,1422,1367,65,57,0,8
21,1391,1194,78,69,0,9
21,1102,1102,73,63,0,10
21,1256,1238,85,58,0,27
21,1402,1394,51,46,0,5
21,1249,1379,63,66,0,-3
21,1317,1115,81,56,0,25
21,1122,1197,70,76,0,-6
21,1190,1205,65,60,0,5
22,1435,1350,67,78,0,-11
22,1247,1269,66,85,0,-19
22,1333,1102,73,61,0,12
22,1160,1303,91,49,0,42
22,1267,1405,87,96,0,-9
22,1274,1338,55,70,0,-15
22,1142,1360,61,70,0,-9
22,1209,1273,88,81,0,7
22,1345,1326,67,60,0,7
22,1153,1378,71,74,0,-3
22,1408,1102,74,80,0,-6
22,1437,1139,85,66,0,19
22,1407,1359,79,71,0,8
22,1292,1279,51,70,0,-19
22,1102,1294,75,83,0,-8
22,1328,1331,79,65,0,14
22,1374,1187,70,55,0,15
22,1240,1399,74,50,0,24
22,1323,1181,65,75,0,-10
22,1329,1395,76,77,0,-1
22,1113,1431,63,76,0,-13
22,1102,1285,58,66,0,-8
22,1393,1318,62,56,0,6
22,1189,1144,66,56,0,10
22,1148,1383,78,59,0,19
22,1214,1456,58,75,0,-17
22,1357,1254,55,75,0,-20
22,1102,1212,61,78,0,-17
22,1151,1421,69,66,0,3
22,1195,1198,69,85,0,-16
22,1125,1244,64,53,0,11
22,1412,1380,88,46,0,42
22,1400,1358,79,63,0,16
22,1280,1146,81,65,0,16
22,1136,1447,74,62,0,12
23,1356,1315,85,64,0,21
23,1385,1166,76,94,0,-18
23,1180,1386,81,77,0,4
23,1403,1242,57,58,0,-1
23,1461,1303,82,78,0,4
23,1266,1371,63,70,0,-7
23,1381,1469,85,78,0,7
23,1258,1414,51,48,0,3
23,1332,1362,74,64,0,10
23,1387,1301,80,69,0,11
23,1357,1254,87,72,0,15
23,1136,1447,81,75,0,6
23,1157,1175,99,73,0,26
23,1133,1238,83,60,0,23
23,1317,1223,85,55,0,30
24,1444,1141,76,61,0,15
24,1356,1315,62,50,0,12
24,1310,1193,68,51,0,17
24,1361,1140,62,72,0,-10
24,1284,1389,78,76,0,2
24,1287,1188,65,69,0,-4
24,1377,1179,57,75,0,-18
24,1348,1172,58,67,0,-9
24,1398,1125,63,88,0,-25
24,1351,1233,56,70,0,-14
24,1296,1152,64,54,0,10
24,1158,1441,70,76,0,-6
24,1397,1399,103,49,0,54
24,1369,1404,67,69,0,-2
24,1450,1286,82,54,0,28
24,1102,1102,79,41,0,38
24,1452,1235,70,65,0,5
24,1429,1294,63,50,0,13
24,1305,1102,74,57,0,17
24,1340,1451,66,94,0,-28
24,1350,1260,75,73,0,2
24,1205,1440,88,77,0,11
24,1313,1423,72,80,0,-8
24,1224,1214,81,76,0,5
24,1342,1354,62,56,0,6
24,1409,1322,82,55,0,27
24,1210,1197,74,64,0,10
24,1352,1132,65,85,0,-20
25,1139,1102,60,68,0,-8
25,1234,1211,88,99,0,-11
25,1458,1257,85,48,0,37
25,1189,1422,64,71,0,-7
25,1232,1123,67,57,0,10
25,1319,1186,64,80,0,-16
25,1102,1460,70,93,0,-23
25,1405,1434,71,57,0,14
25,1297,1464,79,64,0,15
25,1187,1241,73,64,0,9
25,1453,1454,65,68,0,-3
25,1382,1220,77,69,0,8
25,1264,1265,39,61,0,-22
25,1104,1443,71,73,0,-2
25,1246,1314,63,75,0,-12
25,1120,1407,77,41,0,36
25,1102,1402,68,70,0,-2
25,1173,1279,65,62,0,3
25,1323,1345,78,88,0,-10
25,1412,1151,66,69,0,-3
25,1379,1102,60,47,0,13
25,1332,1102,80,41,0,39
25,1243,1124,69,100,0,-31
25,1310,1193,81,61,0,20
25,1326,1417,77,70,0,7
25,1247,1174,71,61,0,10
25,1284,1389,76,78,0,-2
25,1143,1169,87,56,0,31
25,1393,1138,107,96,0,11
25,1337,1102,63,75,0,-12
25,1351,1233,64,72,0,-8
25,1227,1324,74,72,0,2
25,1198,1204,99,103,0,-4
25,1388,1161,53,33,0,20
25,1133,1275,69,68,0,1
25,1208,1153,83,68,0,15
25,1390,1112,78,75,0,3
25,1199,1416,74,86,0,-12
25,1437,1386,88,68,0,20
25,1258,1142,76,52,0,24
25,1236,1156,61,63,0,-2
25,1414,1360,85,53,0,32
25,1255,1154,89,91,0,-2
25,1127,1392,59,73,0,-14
25,1256,1249,86,57,0,29
25,1192,1180,68,85,0,-17
25,1216,1263,63,60,0,3
25,1408,1212,77,65,0,12
25,1456,1219,49,71,0,-22
25,1358,1349,82,69,0,13
25,1105,1375,93,90,0,3
25,1274,1239,73,64,0,9
25,1107,1420,64,65,0,-1
25,1301,1144,69,50,0,19
25,1457,1202,87,71,0,16
25,1150,1102,76,72,0,4
25,1244,1359,63,65,0,-2
25,1396,1312,72,60,0,12
25,1328,1223,84,65,0,19
25,1439,1164,97,57,0,40
25,1435,1347,59,50,0,9
25,1283,1322,94,67,0,27
25,1102,1270,75,65,0,10
26,1163,1166,74,76,0,-2
26,1353,1228,91,88,0,3
26,1102,1460,72,85,0,-13
26,1400,1329,77,74,0,3
26,1116,1331,87,76,0,11
26,1462,1266,91,88,0,3
26,1264,1265,67,72,0,-5
26,1453,1454,62,74,0,-12
26,1297,1464,60,70,0,-10
26,1179,1152,111,67,0,44
26,1340,1451,74,72,0,2
26,1371,1344,77,80,0,-3
26,1227,1324,90,73,0,17
26,1305,1102,66,68,0,-2
26,1404,1442,63,81,0,-18
26,1385,1207,94,83,0,11
26,1321,1277,79,65,0,14
26,1213,1362,65,68,0,-3
26,1278,1387,90,82,0,8
26,1102,1160,69,92,0,-23
26,1236,1156,80,89,0,-9
26,1267,1352,85,71,0,14
26,1330,1318,66,62,0,4
26,1235,1238,60,45,0,15
26,1216,1263,65,50,0,15
26,1107,1420,60,65,0,-5
26,1127,1392,70,80,0,-10
26,1102,1108,88,55,0,33
26,1210,1175,97,69,0,28
27,1155,1287,66,51,0,15
27,1401,1459,70,52,0,18
27,1206,1440,68,66,0,2
27,1319,1402,65,70,0,-5
27,1397,1386,102,66,0,36
27,1191,1125,63,72,0,-9
27,1209,1158,72,55,0,17
27,1139,1356,73,76,0,-3
27,1283,1102,85,77,0,8
27,1102,1409,49,56,0,-7
27,1122,1293,74,70,0,4
27,1390,1167,63,50,0,13
27,1429,1363,107,62,0,45
27,1129,1307,77,53,0,24
27,1144,1423,59,78,0,-19
27,1243,1239,70,46,0,24
27,1349,1102,73,62,0,11
27,1202,1354,118,52,0,66
27,1269,1136,88,93,0,-5
27,1262,1436,73,65,0,8
27,1447,1357,74,46,0,28
27,1149,1214,55,67,0,-12
27,1199,1205,72,59,0,13
27,1410,1358,66,69,0,-3
27,1450,1102,90,62,0,28
27,1280,1290,87,48,0,39
27,1439,1255,84,58,0,26
27,1124,1115,99,42,0,57
27,1211,1322,95,57,0,38
27,1140,1411,87,71,0,16
27,1174,1288,59,65,0,-6
28,1232,1369,72,66,0,6
28,1120,1111,67,53,0,14
28,1103,1325,90,70,0,20
28,1102,1150,65,66,0,-1
28,1102,1319,65,68,0,-3
28,1405,1296,78,55,0,23
28,1444,1123,68,76,0,-8
28,1350,1220,71,76,0,-5
28,1438,1456,76,40,0,36
28,1102,1286,62,59,0,3
28,1187,1408,68,58,0,10
28,1416,1153,75,70,0,5
28,1294,1226,69,64,0,5
28,1433,1241,82,81,0,1
28,1279,1404,90,43,0,47
28,1143,1370,70,65,0,5
28,1338,1257,54,64,0,-10
28,1281,1133,54,53,0,1
28,1172,1435,85,65,0,20
28,1112,1285,70,64,0,6
28,1268,1247,84,71,0,13
28,1378,1455,77,82,0,-5
28,1443,1399,88,68,0,20
28,1328,1403,67,69,0,-2
28,1208,1318,76,58,0,18
28,1398,1151,63,66,0,-3
28,1458,1304,67,53,0,14
28,1179,1315,88,55,0,33
28,1102,1256,57,68,0,-11
28,1104,1190,85,69,0,16
28,1333,1340,67,62,0,5
28,1102,1396,76,50,0,26
28,1301,1314,79,76,0,3
28,1242,1452,79,65,0,14
28,1234,1345,70,55,0,15
28,1395,1295,89,82,0,7
28,1361,1388,74,49,0,25
28,1213,1160,64,74,0,-10
28,1130,1263,78,62,0,16
28,1251,1108,108,65,0,43
28,1244,1273,71,81,0,-10
28,1262,1436,53,62,0,-9
28,1193,1192,65,69,0,-4
28,1154,1342,94,82,0,12
28,1107,1310,65,70,0,-5
28,1447,1357,85,86,0,-1
28,1116,1101,85,72,0,13
28,1267,1421,88,67,0,21
28,1149,1214,68,70,0,-2
28,1102,1422,65,86,0,-21
28,1195,1204,73,60,0,13
28,1102,1249,88,66,0,22
28,1184,1219,86,67,0,19
28,1211,1322,95,78,0,17
29,1166,1462,66,61,0,5
29,1294,1226,56,71,0,-15
29,1206,1406,70,65,0,5
29,1326,1353,80,68,0,12
29,1371,1207,78,67,0,11
29,1139,1344,70,64,0,6
29,1337,1167,51,79,0,-28
29,1336,1228,81,98,0,-17
29,1140,1451,87,79,0,8
29,1266,1437,68,85,0,-17
29,1387,1282,62,46,0,16
29,1102,1321,67,74,0,-7
29,1429,1363,85,52,0,33
29,1177,1442,91,72,0,19
29,1129,1307,89,52,0,37
29,1423,1175,87,63,0,24
29,1383,1389,64,70,0,-6
29,1351,1312,66,81,0,-15
29,1450,1322,62,52,0,10
29,1397,1367,80,60,0,20
29,1233,1164,85,65,0,20
29,1212,1368,70,77,0,-7
29,1323,1468,81,70,0,11
31,1277,1458,76,85,0,-9
31,1345,1268,73,70,0,3
31,1304,1276,69,80,0,-11
31,1278,1234,102,95,0,7
32,1257,1246,62,59,0,3
32,1156,1464,87,69,0,18
32,1321,1326,71,70,0,1
32,1416,1102,54,63,0,-9
32,1460,1453,67,53,0,14
32,1228,1102,69,60,0,9
32,1211,1438,98,75,0,23
32,1236,1352,88,102,0,-14
32,1102,1324,75,77,0,-2
32,1406,1164,78,73,0,5
32,1206,1313,65,68,0,-3
32,1261,1311,86,80,0,6
33,1156,1464,81,74,0,7
33,1232,1179,63,81,0,-18
33,1284,1145,84,66,0,18
33,1460,1453,90,77,0,13
33,1320,1283,59,79,0,-20
33,1356,1191,63,57,0,6
33,1260,1229,90,60,0,30
33,1102,1324,80,83,0,-3
33,1344,1177,95,90,0,5
33,1236,1352,87,82,0,5
33,1414,1102,75,56,0,19
33,1420,1127,74,67,0,7
33,1306,1216,77,69,0,8
33,1436,1312,92,78,0,14
33,1435,1108,87,59,0,28
33,1392,1262,73,58,0,15
34,1284,1145,97,69,0,28
34,1232,1179,66,73,0,-7
34,1356,1191,72,84,0,-12
34,1414,1102,73,69,0,4
34,1260,1229,86,55,0,31
34,1458,1268,64,70,0,-6
34,1320,1283,85,75,0,10
34,1161,1201,75,53,0,22
34,1278,1277,81,56,0,25
34,1211,1319,88,58,0,30
34,1112,1160,88,74,0,14
34,1169,1308,66,63,0,3
34,1420,1127,69,75,0,-6
34,1306,1216,53,51,0,2
34,1436,1312,80,81,0,-1
34,1392,1262,71,64,0,7
35,1452,1318,73,51,0,22
35,1439,1274,80,78,0,2
35,1155,1199,77,67,0,10
35,1261,1401,77,54,0,23
35,1353,1345,81,76,0,5
35,1185,1141,60,87,0,-27
35,1273,1459,65,78,0,-13
35,1425,1365,86,63,0,23
35,1243,1303,60,58,0,2
35,1104,1279,82,64,0,18
35,1234,1321,87,72,0,15
35,1211,1469,112,67,0,45
35,1102,1378,58,57,0,1
35,1409,1102,65,64,0,1
35,1124,1146,93,56,0,37
35,1403,1230,79,51,0,28
35,1249,1368,74,64,0,10
36,1386,1433,64,80,0,-16
36,1151,1202,73,77,0,-4
36,1200,1102,47,71,0,-24
36,1325,1132,75,83,0,-8
36,1396,1374,71,79,0,-8
36,1348,1382,63,57,0,6
36,1161,1201,81,59,0,22
36,1344,1139,71,55,0,16
36,1269,1206,18,18,0,0
36,1323,1438,57,66,0,-9
36,1326,1304,90,54,0,36
36,1190,1441,86,78,0,8
36,1173,1247,65,67,0,-2
36,1125,1293,68,55,0,13
36,1208,1280,73,83,0,-10
36,1120,1116,85,97,0,-12
36,1172,1350,74,80,0,-6
36,1462,1371,68,85,0,-17
36,1301,1130,79,76,0,3
36,1359,1440,84,71,0,13
36,1210,1314,72,67,0,5
36,1184,1183,69,61,0,8
36,1102,1336,7,5,0,2
36,1240,1404,80,70,0,10
36,1399,1369,72,63,0,9
36,1163,1177,82,61,0,21
36,1398,1122,59,68,0,-9
36,1281,1397,53,73,0,-20
36,1435,1196,72,91,0,-19
36,1370,1102,84,68,0,16
36,1388,1170,63,45,0,18
36,1175,1264,59,65,0,-6
36,1214,1205,80,69,0,11
36,1255,1421,73,80,0,-7
36,1457,1144,84,83,0,1
36,1124,1108,105,76,0,29
36,1342,1347,65,71,0,-6
36,1219,1367,63,52,0,11
36,1395,1102,66,61,0,5
37,1102,1429,48,83,0,-35
37,1458,1278,71,59,0,12
37,1362,1360,70,62,0,8
37,1417,1102,72,70,0,2
37,1268,1276,73,84,0,-11
37,1102,1112,53,80,0,-27
37,1307,1305,54,68,0,-14
37,1425,1160,62,72,0,-10
37,1102,1319,65,78,0,-13
37,1363,1129,54,106,0,-52
37,1332,1143,82,69,0,13
37,1214,1205,69,80,0,-11
37,1457,1144,94,76,0,18
37,1255,1421,65,55,0,10
37,1342,1347,65,63,0,2
37,1219,1367,51,60,0,-9
38,1145,1389,70,58,0,12
38,1352,1454,67,64,0,3
38,1237,1156,62,65,0,-3
38,1265,1310,63,61,0,2
38,1349,1102,95,86,0,9
38,1464,1453,84,77,0,7
38,1150,1443,63,67,0,-4
38,1193,1351,62,70,0,-8
38,1102,1426,102,93,0,9
38,1111,1407,56,69,0,-13
38,1204,1375,59,88,0,-29
38,1297,1236,75,68,0,7
38,1157,1209,81,69,0,12
38,1253,1167,90,89,0,1
38,1198,1330,82,67,0,15
38,1324,1460,51,90,0,-39
38,1102,1117,84,72,0,12
38,1102,1402,83,77,0,6
38,1256,1267,75,68,0,7
38,1102,1168,81,63,0,18
38,1379,1431,74,66,0,8
38,1103,1245,66,62,0,4
38,1252,1251,77,70,0,7
38,1244,1239,57,62,0,-5
39,1318,1189,75,52,0,23
39,1130,1257,64,76,0,-12
39,1237,1156,49,59,0,-10
39,1116,1281,68,81,0,-13
39,1242,1400,59,84,0,-25
39,1344,1166,65,67,0,-2
39,1102,1182,63,75,0,-12
39,1235,1124,65,76,0,-11
39,1145,1389,63,60,0,3
39,1440,1151,84,79,0,5
39,1444,1405,59,70,0,-11
39,1353,1234,75,77,0,-2
39,1220,1456,61,56,0,5
39,1243,1395,60,67,0,-7
39,1408,1187,60,56,0,4
39,1202,1273,83,80,0,3
39,1247,1200,89,52,0,37
39,1174,1158,70,67,0,3
39,1274,1155,65,66,0,-1
39,1196,1261,83,79,0,4
39,1265,1310,72,86,0,-14
39,1153,1409,66,70,0,-4
39,1123,1325,68,78,0,-10
39,1102,1319,78,83,0,-5
39,1198,1330,66,71,0,-5
39,1204,1375,62,49,0,13
39,1349,1102,84,69,0,15
39,1157,1209,62,70,0,-8
39,1401,1120,68,66,0,2
39,1464,1453,69,79,0,-10
39,1111,1407,90,59,0,31
39,1150,1443,75,71,0,4
39,1328,1452,75,71,0,4
39,1425,1102,64,46,0,18
39,1403,1329,77,82,0,-5
39,1191,1320,65,61,0,4
39,1361,1161,67,70,0,-3
39,1315,1282,52,45,0,7
39,1173,1206,74,65,0,9
39,1371,1139,68,60,0,8
39,1442,1295,50,68,0,-18
39,1324,1460,81,71,0,10
39,1183,1399,87,81,0,6
39,1293,1287,56,61,0,-5
39,1102,1117,62,55,0,7
39,1102,1402,59,71,0,-12
39,1404,1125,69,90,0,-21
39,1350,1382,66,69,0,-3
39,1193,1351,72,56,0,16
39,1422,1190,61,71,0,-10
39,1379,1431,62,77,0,-15
39,1377,1102,93,54,0,39
39,1122,1184,75,80,0,-5
39,1102,1426,75,62,0,13
39,1303,1331,83,95,0,-12
39,1296,1132,42,68,0,-26
39,1397,1104,63,71,0,-8
39,1228,1345,66,58,0,8
39,1297,1236,70,68,0,2
39,1369,1398,83,79,0,4
39,1102,1429,53,72,0,-19
39,1283,1232,84,74,0,10
39,1333,1143,73,64,0,9
39,1279,1455,79,83,0,-4
39,1280,1246,73,78,0,-5
39,1285,1294,62,64,0,-2
39,1253,1167,76,89,0,-13
39,1256,1267,73,80,0,-7
39,1378,1416,68,61,0,7
39,1201,1461,74,78,0,-4
39,1459,1359,94,84,0,10
39,1207,1266,60,64,0,-4
39,1304,1277,77,84,0,-7
39,1102,1168,65,61,0,4
39,1417,1160,65,62,0,3
39,1363,1129,86,87,0,-1
39,1211,1362,85,62,0,23
39,1332,1390,73,56,0,17
39,1307,1305,74,84,0,-10
39,1450,1112,82,86,0,-4
39,1314,1323,66,65,0,1
39,1260,1317,57,49,0,8
39,1451,1430,70,62,0,8
39,1376,1197,78,71,0,7
39,1216,1127,76,56,0,20
39,1298,1137,78,69,0,9
39,1354,1102,86,97,0,-11
39,1250,1248,90,89,0,1
39,1159,1119,101,57,0,44
39,1262,1312,67,73,0,-6
39,1263,1306,59,56,0,3
39,1244,1239,66,72,0,-6
39,1101,1249,83,65,0,18
39,1270,1146,67,81,0,-14
39,1252,1251,50,66,0,-16
39,1106,1212,49,66,0,-17
39,1372,1102,78,67,0,11
39,1311,1358,81,84,0,-3
39,1436,1107,62,63,0,-1
39,1115,1290,92,52,0,40
39,1223,1322,99,93,0,6
40,1318,1189,66,58,0,8
40,1220,1456,82,73,0,9
40,1102,1182,75,73,0,2
40,1174,1158,59,66,0,-7
40,1373,1284,78,77,0,1
40,1283,1232,70,66,0,4
40,1191,1320,70,64,0,6
40,1348,1386,85,77,0,8
40,1315,1282,53,77,0,-24
40,1442,1295,67,78,0,-11
40,1377,1102,79,57,0,22
40,1303,1331,75,86,0,-11
40,1278,1326,77,60,0,17
40,1179,1356,73,55,0,18
40,1210,1448,70,54,0,16
40,1374,1102,60,74,0,-14
40,1276,1321,85,66,0,19
40,1263,1306,58,62,0,-4
40,1262,1312,74,60,0,14
40,1216,1127,77,74,0,3
40,1159,1119,73,75,0,-2
40,1354,1102,66,73,0,-7
40,1248,1250,82,70,0,12
40,1436,1107,74,66,0,8
40,1137,1298,60,63,0,-3
40,1241,1288,73,80,0,-7
41,1285,1294,56,54,0,2
41,1333,1390,71,81,0,-10
41,1373,1284,76,62,0,14
41,1179,1356,86,55,0,31
41,1102,1268,63,55,0,8
41,1201,1461,81,61,0,20
41,1329,1452,84,87,0,-3
41,1361,1161,78,65,0,13
41,1221,1131,76,83,0,-7
41,1149,1457,69,85,0,-16
41,1367,1255,71,69,0,2
41,1205,1144,61,70,0,-9
41,1347,1214,79,66,0,13
41,1164,1175,86,78,0,8
41,1106,1238,44,60,0,-16
42,1245,1405,82,84,0,-2
42,1325,1296,76,73,0,3
42,1132,1141,90,69,0,21
42,1200,1173,55,54,0,1
42,1246,1435,77,74,0,3
42,1182,1172,48,61,0,-13
42,1155,1301,74,70,0,4
42,1403,1243,82,71,0,11
42,1104,1196,86,71,0,15
42,1400,1235,78,72,0,6
42,1274,1314,65,67,0,-2
42,1277,1353,68,45,0,23
42,1266,1163,54,65,0,-11
42,1280,1281,78,63,0,15
42,1395,1242,64,93,0,-29
42,1241,1194,79,70,0,9
42,1131,1221,66,68,0,-2
42,1149,1457,76,78,0,-2
42,1205,1144,85,70,0,15
42,1367,1255,65,59,0,6
42,1347,1214,76,65,0,11
42,1164,1175,81,77,0,4
43,1382,1386,83,57,0,26
43,1378,1409,51,61,0,-10
43,1393,1338,60,63,0,-3
43,1350,1348,80,73,0,7
43,1257,1439,73,71,0,2
43,1151,1359,73,68,0,5
43,1206,1433,61,66,0,-5
43,1139,1207,63,55,0,8
43,1397,1116,79,74,0,5
43,1261,1208,94,92,0,2
43,1459,1422,75,84,0,-9
43,1102,1455,70,63,0,7
43,1462,1385,69,61,0,8
43,1181,1130,83,82,0,1
43,1276,1278,82,57,0,25
43,1166,1371,89,53,0,36
43,1124,1328,76,61,0,15
43,1376,1401,78,54,0,24
43,1279,1120,72,61,0,11
43,1438,1448,70,61,0,9
43,1307,1429,45,77,0,-32
43,1129,1102,78,59,0,19
43,1322,1230,67,75,0,-8
43,1368,1358,52,70,0,-18
43,1146,1102,83,79,0,4
43,1223,1101,63,66,0,-3
43,1311,1249,76,69,0,7
44,1287,1399,57,54,0,3
44,1125,1369,77,66,0,11
44,1220,1318,78,81,0,-3
44,1268,1234,67,89,0,-22
44,1458,1102,80,73,0,7
44,1374,1153,69,76,0,-7
44,1184,1240,69,66,0,3
44,1319,1226,69,73,0,-4
44,1161,1424,74,71,0,3
44,1183,1293,74,68,0,6
44,1294,1286,67,79,0,-12
44,1381,1102,85,80,0,5
44,1362,1102,88,64,0,24
44,1398,1404,74,62,0,12
44,1390,1102,91,75,0,16
44,1112,1425,73,87,0,-14
44,1321,1228,56,81,0,-25
44,1361,1305,65,60,0,5
44,1143,1450,60,71,0,-11
44,1113,1417,75,81,0,-6
44,1160,1332,79,72,0,7
44,1211,1140,86,69,0,17
44,1136,1148,93,68,0,25
44,1254,1384,78,75,0,3
44,1383,1102,70,55,0,15
44,1467,1357,97,90,0,7
45,1346,1264,84,79,0,5
45,1310,1351,70,76,0,-6
45,1453,1324,84,81,0,3
45,1111,1204,66,63,0,3
45,1157,1375,78,65,0,13
45,1405,1325,95,78,0,17
45,1102,1102,66,64,0,2
45,1460,1464,72,74,0,-2
45,1236,1227,96,89,0,7
45,1102,1426,64,77,0,-13
45,1330,1194,71,67,0,4
45,1102,1317,70,77,0,-7
45,1277,1345,54,55,0,-1
45,1292,1198,55,68,0,-13
45,1415,1218,83,88,0,-5
45,1156,1297,58,44,0,14
45,1412,1379,72,60,0,12
45,1168,1253,80,82,0,-2
45,1430,1465,77,50,0,27
45,1129,1102,80,69,0,11
45,1282,1377,64,66,0,-2
45,1443,1256,66,64,0,2
45,1470,1213,72,75,0,-3
45,1295,1303,71,69,0,2
45,1331,1315,71,72,0,-1
45,1355,1442,83,77,0,6
45,1201,1363,79,64,0,15
45,1172,1173,78,89,0,-11
45,1431,1349,101,89,0,12
45,1167,1142,62,49,0,13
45,1307,1429,46,82,0,-36
45,1454,1237,94,70,0,24
45,1254,1384,71,58,0,13
45,1467,1357,62,68,0,-6
45,1383,1102,67,55,0,12
45,1136,1148,76,64,0,12
45,1251,1244,69,63,0,6
45,1466,1391,77,86,0,-9
45,1468,1252,72,77,0,-5
45,1239,1316,66,65,0,1
46,1166,1385,97,79,0,18
46,1181,1448,79,68,0,11
46,1301,1274,59,64,0,-5
46,1120,1104,90,94,0,-4
46,1206,1350,57,77,0,-20
46,1353,1326,68,79,0,-11
46,1454,1237,71,63,0,8
46,1318,1220,67,56,0,11
46,1275,1296,70,58,0,12
46,1452,1400,70,72,0,-2
46,1158,1180,61,60,0,1
46,1154,1151,92,87,0,5
46,1187,1378,63,69,0,-6
46,1435,1280,81,84,0,-3
46,1401,1397,54,68,0,-14
46,1433,1348,68,83,0,-15
46,1182,1200,48,45,0,3
46,1434,1283,68,81,0,-13
46,1319,1226,70,76,0,-6
46,1381,1102,83,67,0,16
46,1177,1371,68,76,0,-8
46,1130,1438,49,61,0,-12
46,1294,1286,74,76,0,-2
46,1456,1174,67,62,0,5
46,1191,1229,57,48,0,9
46,1284,1265,80,64,0,16
46,1185,1103,71,59,0,12
46,1143,1102,84,78,0,6
46,1460,1464,93,55,0,38
46,1395,1124,49,67,0,-18
46,1157,1375,83,69,0,14
46,1116,1208,99,69,0,30
46,1287,1240,56,55,0,1
46,1245,1444,80,54,0,26
46,1346,1264,42,45,0,-3
46,1310,1351,66,55,0,11
46,1102,1317,77,69,0,8
46,1269,1247,83,67,0,16
46,1161,1424,83,80,0,3
46,1111,1204,77,71,0,6
46,1235,1403,64,91,0,-27
46,1193,1373,58,74,0,-16
46,1102,1408,71,50,0,21
46,1139,1163,60,72,0,-12
46,1242,1328,63,59,0,4
46,1141,1132,65,93,0,-28
46,1236,1227,88,55,0,33
46,1102,1426,74,75,0,-1
46,1292,1198,67,56,0,11
46,1102,1102,76,78,0,-2
46,1138,1123,86,69,0,17
46,1196,1246,58,76,0,-18
46,1183,1122,71,74,0,-3
46,1453,1324,87,78,0,9
46,1412,1379,62,58,0,4
46,1125,1404,89,69,0,20
46,1390,1450,75,60,0,15
46,1243,1329,54,70,0,-16
46,1184,1399,90,80,0,10
46,1330,1194,64,55,0,9
46,1443,1256,58,63,0,-5
46,1388,1365,64,66,0,-2
46,1156,1297,74,71,0,3
46,1430,1465,81,77,0,4
46,1168,1253,75,72,0,3
46,1393,1207,74,69,0,5
46,1282,1377,62,68,0,-6
46,1102,1211,88,116,0,-28
46,1470,1213,48,59,0,-11
46,1295,1303,80,66,0,14
46,1355,1442,92,63,0,29
46,1331,1315,74,57,0,17
46,1361,1305,69,67,0,2
46,1431,1349,68,71,0,-3
46,1112,1417,76,81,0,-5
46,1102,1332,73,79,0,-6
46,1167,1142,67,50,0,17
46,1471,1414,65,79,0,-14
46,1279,1261,61,75,0,-14
46,1422,1459,45,48,0,-3
46,1262,1216,71,62,0,9
46,1306,1420,54,69,0,-15
46,1313,1288,74,78,0,-4
46,1312,1263,63,54,0,9
46,1127,1436,60,76,0,-16
46,1250,1298,61,69,0,-8
46,1221,1119,68,83,0,-15
46,1214,1421,73,71,0,2
46,1249,1223,71,65,0,6
46,1137,1248,60,83,0,-23
46,1149,1347,64,79,0,-15
46,1146,1358,80,91,0,-11
46,1270,1322,75,78,0,-3
46,1251,1244,76,47,0,29
46,1468,1252,58,65,0,-7
46,1239,1316,68,70,0,-2
46,1131,1159,79,86,0,-7
46,1386,1107,67,64,0,3
46,1311,1368,87,67,0,20
46,1255,1144,58,64,0,-6
46,1115,1106,91,82,0,9
46,1212,1380,55,61,0,-6
46,1102,1230,86,64,0,22
46,1466,1391,73,66,0,7
46,1457,1205,75,65,0,10
47,1462,1344,74,73,0,1
47,1158,1180,73,68,0,5
47,1434,1283,68,78,0,-10
47,1191,1229,68,73,0,-5
47,1284,1265,72,62,0,10
47,1234,1278,86,71,0,15
47,1193,1373,68,75,0,-7
47,1320,1133,78,72,0,6
47,1455,1153,82,76,0,6
47,1304,1102,76,84,0,-8
47,1439,1323,77,63,0,14
47,1201,1363,80,65,0,15
47,1228,1268,63,66,0,-3
47,1232,1260,76,71,0,5
47,1258,1362,68,60,0,8
47,1306,1420,66,68,0,-2
47,1214,1421,77,85,0,-8
47,1457,1205,91,83,0,8
47,1262,1216,58,75,0,-17
47,1313,1288,89,85,0,4
47,1312,1263,41,45,0,-4
47,1127,1436,44,84,0,-40
47,1119,1221,61,70,0,-9
47,1149,1347,48,68,0,-20
47,1298,1250,73,58,0,15
47,1248,1137,87,76,0,11
47,1255,1144,78,69,0,9
47,1131,1159,45,89,0,-44
47,1197,1354,70,68,0,2
48,1374,1396,79,68,0,11
48,1102,1160,58,65,0,-7
48,1177,1163,53,60,0,-7
48,1232,1260,48,58,0,-10
48,1320,1133,73,75,0,-2
48,1461,1129,60,83,0,-23
48,1102,1411,73,67,0,6
49,1444,1138,69,85,0,-16
49,1296,1103,67,65,0,2
49,1141,1245,85,94,0,-9
49,1325,1275,78,61,0,17
49,1172,1386,80,66,0,14
49,1385,1139,69,57,0,12
49,1130,1274,84,62,0,22
49,1276,1458,77,54,0,23
49,1132,1123,64,88,0,-24
49,1196,1279,72,63,0,9
49,1439,1181,74,67,0,7
49,1405,1185,96,63,0,33
49,1328,1395,82,46,0,36
49,1329,1242,75,70,0,5
49,1266,1344,79,69,0,10
49,1246,1104,65,85,0,-20
49,1314,1393,81,75,0,6
49,1425,1415,67,62,0,5
49,1290,1106,51,64,0,-13
49,1212,1108,79,74,0,5
50,1200,1382,54,68,0,-14
50,1102,1433,77,84,0,-7
50,1438,1323,80,68,0,12
50,1199,1301,105,73,0,32
50,1440,1459,78,80,0,-2
50,1173,1182,72,63,0,9
50,1151,1273,83,80,0,3
50,1154,1202,88,94,0,-6
50,1206,1247,75,42,0,33
50,1455,1409,72,53,0,19
50,1326,1321,81,71,0,10
50,1269,1348,80,78,0,2
50,1208,1120,77,95,0,-18
50,1261,1116,92,76,0,16
50,1448,1257,65,77,0,-12
50,1461,1129,70,90,0,-20
50,1400,1403,77,79,0,-2
50,1280,1401,55,56,0,-1
50,1469,1307,63,72,0,-9
50,1372,1146,95,69,0,26
50,1322,1311,66,76,0,-10
50,1358,1249,96,71,0,25
50,1230,1270,83,61,0,22
50,1368,1394,76,63,0,13
51,1396,1416,62,55,0,7
51,1160,1143,89,60,0,29
51,1334,1365,79,58,0,21
51,1102,1390,79,65,0,14
51,1211,1337,95,70,0,25
51,1417,1450,91,61,0,30
51,1198,1194,79,81,0,-2
51,1285,1319,67,56,0,11
51,1102,1345,69,81,0,-12
51,1102,1362,63,79,0,-16
51,1286,1340,71,64,0,7
51,1240,1398,65,64,0,1
51,1429,1361,57,45,0,12
51,1102,1294,54,74,0,-20
51,1399,1125,67,88,0,-21
51,1186,1381,75,63,0,12
51,1183,1287,61,87,0,-26
51,1363,1161,57,90,0,-33
51,1425,1102,95,68,0,27
51,1388,1140,52,62,0,-10
51,1333,1112,64,98,0,-34
51,1359,1422,63,87,0,-24
51,1421,1149,92,54,0,38
51,1367,1214,68,69,0,-1
51,1457,1255,72,61,0,11
51,1447,1254,66,77,0,-11
51,1384,1136,89,82,0,7
51,1144,1342,48,46,0,2
51,1357,1148,65,48,0,17
51,1102,1467,77,57,0,20
52,1102,1331,84,88,0,-4
52,1349,1330,69,59,0,10
52,1264,1310,58,49,0,9
52,1284,1346,92,80,0,12
52,1265,1193,73,63,0,10
52,1150,1412,37,61,0,-24
52,1443,1267,81,73,0,8
52,1297,1237,69,74,0,-5
52,1204,1407,67,64,0,3
52,1102,1453,86,61,0,25
52,1138,1132,69,76,0,-7
52,1426,1102,91,86,0,5
52,1324,1464,82,65,0,17
52,1454,1236,72,81,0,-9
52,1460,1156,64,66,0,-2
52,1142,1415,51,86,0,-35
52,1117,1102,74,72,0,2
52,1351,1373,69,78,0,-9
52,1375,1111,73,64,0,9
52,1382,1182,62,48,0,14
52,1410,1469,82,49,0,33
52,1256,1102,77,66,0,11
52,1102,1402,59,63,0,-4
52,1317,1431,63,33,0,30
52,1379,1292,84,54,0,30
52,1102,1471,69,52,0,17
52,1227,1352,67,53,0,14
52,1315,1295,45,62,0,-17
52,1353,1458,54,60,0,-6
52,1465,1470,83,74,0,9
52,1370,1430,92,93,0,-1
52,1305,1201,73,57,0,16
52,1218,1167,55,60,0,-5
52,1174,1220,74,56,0,18
52,1421,1149,83,75,0,8
52,1384,1136,63,72,0,-9
52,1102,1467,63,52,0,11
52,1244,1466,43,66,0,-23
52,1367,1214,74,84,0,-10
52,1457,1255,70,50,0,20
52,1447,1254,76,74,0,2
52,1195,1468,60,74,0,-14
52,1391,1251,65,59,0,6
52,1144,1342,73,51,0,22
52,1252,1316,84,72,0,12
53,1228,1326,81,87,0,-6
53,1199,1314,82,75,0,7
53,1338,1393,96,76,0,20
53,1279,1208,74,78,0,-4
53,1440,1154,110,103,0,7
53,1180,1456,82,58,0,24
53,1123,1296,78,58,0,20
53,1158,1318,62,67,0,-5
53,1401,1281,52,68,0,-16
53,1285,1319,58,62,0,-4
53,1429,1361,64,59,0,5
53,1406,1241,72,81,0,-9
53,1103,1405,95,94,0,1
53,1325,1245,79,89,0,-10
53,1139,1166,70,66,0,4
53,1273,1441,78,76,0,2
53,1385,1266,71,73,0,-2
53,1151,1459,59,77,0,-18
53,1348,1206,80,60,0,20
53,1278,1276,75,57,0,18
53,1120,1246,66,59,0,7
53,1102,1331,82,91,0,-9
53,1349,1330,58,61,0,-3
53,1286,1340,69,64,0,5
53,1247,1172,53,77,0,-24
53,1204,1407,63,56,0,7
53,1359,1422,70,82,0,-12
53,1324,1464,81,74,0,7
53,1102,1294,61,75,0,-14
53,1160,1390,77,64,0,13
53,1186,1381,94,99,0,-5
53,1104,1116,90,59,0,31
53,1102,1461,72,69,0,3
53,1264,1310,58,55,0,3
53,1194,1198,107,63,0,44
53,1133,1191,69,60,0,9
53,1317,1431,74,65,0,9
53,1229,1232,65,73,0,-8
53,1150,1412,70,55,0,15
53,1209,1157,71,68,0,3
53,1403,1124,60,68,0,-8
53,1202,1190,78,66,0,12
53,1280,1196,72,69,0,3
53,1323,1130,80,70,0,10
53,1177,1434,77,58,0,19
53,1141,1185,75,64,0,11
53,1334,1258,58,49,0,9
53,1183,1184,85,93,0,-8
53,1426,1102,51,68,0,-17
53,1404,1293,57,79,0,-22
53,1284,1346,70,63,0,7
53,1265,1193,52,55,0,-3
53,1117,1102,93,72,0,21
53,1240,1125,91,98,0,-7
53,1417,1102,81,76,0,5
53,1379,1292,64,59,0,5
53,1102,1402,56,67,0,-11
53,1375,1111,77,83,0,-6
53,1102,1453,68,65,0,3
53,1369,1287,50,64,0,-14
53,1424,1307,77,54,0,23
53,1363,1161,61,88,0,-27
53,1297,1237,63,65,0,-2
53,1260,1320,72,57,0,15
53,1397,1435,81,61,0,20
53,1155,1438,50,85,0,-35
53,1227,1352,66,62,0,4
53,1256,1102,82,66,0,16
53,1454,1236,74,81,0,-7
53,1460,1156,85,49,0,36
53,1142,1415,53,70,0,-17
53,1410,1469,72,65,0,7
53,1337,1102,80,65,0,15
53,1333,1113,80,79,0,1
53,1351,1373,72,74,0,-2
53,1388,1211,59,73,0,-14
53,1274,1257,78,72,0,6
53,1400,1243,82,67,0,15
53,1102,1471,84,53,0,31
53,1315,1295,82,78,0,4
53,1261,1376,85,80,0,5
53,1399,1398,74,71,0,3
53,1465,1470,73,67,0,6
53,1425,1450,85,77,0,8
53,1362,1140,63,72,0,-9
53,1102,1143,63,72,0,-9
53,1218,1167,72,83,0,-11
53,1408,1396,57,65,0,-8
53,1168,1169,85,86,0,-1
53,1298,1110,87,86,0,1
53,1159,1221,95,55,0,40
53,1420,1216,63,70,0,-7
53,1131,1119,59,79,0,-20
53,1392,1306,64,81,0,-17
53,1288,1164,92,72,0,20
53,1137,1250,75,70,0,5
53,1127,1262,78,92,0,-14
53,1436,1263,65,30,0,35
53,1248,1259,77,75,0,2
53,1101,1368,76,42,0,34
53,1244,1466,64,66,0,-2
53,1175,1313,76,87,0,-11
53,1391,1251,58,68,0,-10
53,1146,1311,72,74,0,-2
53,1107,1312,83,75,0,8
53,1105,1106,70,63,0,7
53,1380,1115,88,53,0,35
53,1252,1316,67,72,0,-5
53,1108,1290,71,59,0,12
53,1102,1270,99,84,0,15
53,1195,1468,63,80,0,-17
53,1230,1372,65,83,0,-18
53,1411,1212,72,78,0,-6
54,1321,1234,73,96,0,-23
54,1345,1336,80,72,0,8
54,1180,1456,64,69,0,-5
54,1158,1318,66,68,0,-2
54,1174,1220,67,68,0,-1
54,1267,1443,67,69,0,-2
54,1102,1416,75,58,0,17
54,1200,1269,46,65,0,-19
54,1409,1102,58,57,0,1
54,1226,1170,57,56,0,1
54,1305,1201,79,65,0,14
54,1133,1191,86,55,0,31
54,1229,1232,68,74,0,-6
54,1102,1173,54,67,0,-13
54,1260,1320,88,46,0,42
54,1360,1365,63,69,0,-6
54,1448,1439,60,64,0,-4
54,1451,1470,94,79,0,15
54,1168,1169,85,77,0,8
54,1127,1262,67,77,0,-10
54,1298,1110,71,59,0,12
54,1159,1221,96,87,0,9
54,1436,1263,88,60,0,28
54,1420,1216,57,49,0,8
54,1131,1119,65,76,0,-11
54,1392,1306,64,67,0,-3
54,1288,1164,79,89,0,-10
54,1250,1137,61,77,0,-16
54,1107,1312,83,71,0,12
54,1175,1313,79,83,0,-4
54,1259,1248,70,72,0,-2
55,1406,1423,72,69,0,3
55,1359,1441,82,78,0,4
55,1247,1386,90,83,0,7
55,1163,1385,70,74,0,-4
55,1422,1154,87,73,0,14
55,1190,1440,92,81,0,11
55,1257,1199,65,78,0,-13
55,1102,1461,58,77,0,-19
55,1124,1242,77,69,0,8
55,1424,1307,53,46,0,7
55,1226,1170,65,70,0,-5
55,1108,1115,82,48,0,34
55,1380,1290,102,61,0,41
55,1102,1212,59,50,0,9
56,1406,1423,78,74,0,4
56,1245,1138,84,81,0,3
56,1326,1345,65,67,0,-2
56,1328,1243,76,50,0,26
56,1275,1123,81,71,0,10
56,1276,1268,87,63,0,24
56,1177,1139,53,67,0,-14
56,1393,1274,83,57,0,26
56,1132,1103,57,69,0,-12
56,1196,1397,75,49,0,26
56,1281,1376,81,70,0,11
56,1405,1141,89,72,0,17
56,1333,1425,58,56,0,2
56,1398,1369,59,63,0,-4
56,1228,1336,79,65,0,14
56,1429,1161,83,64,0,19
56,1437,1371,76,74,0,2
56,1338,1181,79,73,0,6
56,1261,1104,75,105,0,-30
56,1280,1279,46,64,0,-18
56,1258,1360,72,69,0,3
56,1255,1219,75,54,0,21
56,1342,1457,58,72,0,-14
56,1205,1421,75,79,0,-4
56,1144,1347,91,97,0,-6
57,1172,1200,73,58,0,15
57,1441,1190,48,59,0,-11
57,1382,1433,70,54,0,16
57,1182,1348,71,69,0,2
57,1210,1155,83,65,0,18
57,1154,1273,63,83,0,-20
57,1434,1260,39,75,0,-36
57,1440,1202,74,73,0,1
57,1206,1386,87,85,0,2
57,1208,1246,63,62,0,1
57,1314,1448,80,73,0,7
57,1102,1409,86,59,0,27
57,1359,1151,64,70,0,-6
57,1102,1160,84,80,0,4
57,1166,1344,70,74,0,-4
57,1116,1120,75,73,0,2
57,1229,1133,71,56,0,15
57,1458,1321,68,52,0,16
57,1129,1201,73,51,0,22
57,1342,1457,66,78,0,-12
57,1255,1219,67,54,0,13
57,1205,1421,84,57,0,27
57,1372,1322,86,74,0,12
57,1270,1368,88,92,0,-4
57,1223,1311,83,92,0,-9
57,1102,1394,87,68,0,19
57,1358,1101,64,57,0,7
57,1144,1347,61,67,0,-6
58,1138,1185,92,77,0,15
58,1307,1363,67,51,0,16
58,1275,1132,96,77,0,19
58,1103,1141,81,67,0,14
58,1336,1353,75,67,0,8
58,1287,1369,76,65,0,11
58,1102,1455,72,52,0,20
58,1184,1404,113,73,0,40
58,1258,1388,61,65,0,-4
58,1125,1183,79,66,0,13
58,1319,1286,51,62,0,-11
58,1170,1285,66,78,0,-12
58,1294,1186,78,76,0,2
58,1293,1240,82,85,0,-3
58,1122,1399,72,69,0,3
58,1140,1102,95,67,0,28
58,1337,1334,85,68,0,17
58,1234,1102,69,81,0,-12
58,1143,1417,57,61,0,-4
58,1113,1112,82,84,0,-2
58,1451,1381,91,67,0,24
58,1398,1188,65,67,0,-2
58,1365,1362,50,73,0,-23
58,1450,1102,56,71,0,-15
58,1340,1226,57,64,0,-7
58,1429,1161,76,84,0,-8
58,1467,1192,62,51,0,11
58,1357,1384,58,76,0,-18
58,1148,1102,57,67,0,-10
59,1237,1460,65,95,0,-30
59,1346,1310,56,59,0,-3
59,1464,1227,66,67,0,-1
59,1453,1236,77,59,0,18
59,1111,1209,80,71,0,9
59,1157,1407,90,81,0,9
59,1351,1265,76,64,0,12
59,1345,1276,53,70,0,-17
59,1102,1402,47,57,0,-10
59,1426,1102,59,66,0,-7
59,1352,1297,76,81,0,-5
59,1373,1389,62,68,0,-6
59,1324,1102,86,81,0,5
59,1198,1267,66,79,0,-13
59,1194,1150,66,53,0,13
59,1414,1142,68,49,0,19
59,1169,1102,58,105,0,-47
59,1415,1167,45,47,0,-2
59,1102,1117,81,68,0,13
59,1102,1379,70,64,0,6
59,1471,1413,89,69,0,20
59,1375,1204,75,84,0,-9
59,1412,1349,78,68,0,10
59,1168,1218,83,67,0,16
59,1461,1305,71,64,0,7
59,1442,1377,60,65,0,-5
59,1295,1102,70,58,0,12
59,1355,1315,92,73,0,19
59,1156,1454,64,53,0,11
59,1431,1256,82,74,0,8
59,1469,1213,74,77,0,-3
59,1102,1361,61,98,0,-37
59,1357,1384,82,70,0,12
59,1148,1102,65,64,0,1
59,1467,1192,76,71,0,5
59,1466,1239,82,81,0,1
59,1468,1391,67,62,0,5
59,1316,1244,69,54,0,15
59,1252,1195,69,79,0,-10
60,1328,1242,75,68,0,7
60,1151,1422,66,74,0,-8
60,1376,1120,86,109,0,-23
60,1393,1439,78,60,0,18
60,1237,1460,72,100,0,-28
60,1405,1245,76,74,0,2
60,1396,1102,51,68,0,-17
60,1166,1163,74,66,0,8
60,1318,1241,72,63,0,9
60,1386,1206,62,71,0,-9
60,1423,1174,77,70,0,7
60,1435,1116,71,92,0,-21
60,1278,1268,49,63,0,-14
60,1273,1440,83,80,0,3
60,1381,1451,77,72,0,5
60,1314,1301,86,76,0,10
60,1294,1186,76,82,0,-6
60,1198,1267,72,89,0,-17
60,1220,1406,71,58,0,13
60,1416,1374,65,78,0,-13
60,1329,1124,66,81,0,-15
60,1208,1196,84,92,0,-8
60,1319,1286,53,58,0,-5
60,1307,1363,71,83,0,-12
60,1170,1285,89,83,0,6
60,1437,1344,71,56,0,15
60,1350,1247,78,84,0,-6
60,1199,1155,80,61,0,19
60,1157,1407,70,65,0,5
60,1340,1226,69,43,0,26
60,1279,1401,61,50,0,11
60,1243,1452,47,69,0,-22
60,1287,1404,76,44,0,32
60,1194,1150,71,74,0,-3
60,1257,1181,70,65,0,5
60,1190,1202,71,62,0,9
60,1111,1209,74,61,0,13
60,1102,1379,78,72,0,6
60,1458,1326,62,74,0,-12
60,1459,1441,91,78,0,13
60,1385,1430,96,78,0,18
60,1346,1310,78,69,0,9
60,1433,1173,66,43,0,23
60,1464,1227,85,77,0,8
60,1390,1417,73,72,0,1
60,1125,1188,114,62,0,52
60,1398,1183,65,54,0,11
60,1102,1402,63,69,0,-6
60,1426,1102,66,61,0,5
60,1412,1349,86,74,0,12
60,1352,1297,74,79,0,-5
60,1292,1443,67,82,0,-15
60,1324,1102,72,82,0,-10
60,1156,1454,80,81,0,-1
60,1102,1117,77,74,0,3
60,1453,1236,87,72,0,15
60,1122,1240,70,76,0,-6
60,1102,1360,70,78,0,-8
60,1375,1204,62,48,0,14
60,1444,1103,68,79,0,-11
60,1471,1413,71,78,0,-7
60,1185,1275,63,85,0,-22
60,1104,1280,81,73,0,8
60,1246,1261,82,69,0,13
60,1266,1177,61,68,0,-7
60,1229,1434,60,69,0,-9
60,1448,1338,76,75,0,1
60,1351,1265,67,76,0,-9
60,1258,1365,69,72,0,-3
60,1336,1321,81,78,0,3
60,1373,1389,47,40,0,7
60,1414,1142,67,44,0,23
60,1169,1102,66,80,0,-14
60,1415,1167,70,63,0,7
60,1362,1388,63,67,0,-4
60,1182,1382,61,65,0,-4
60,1168,1218,53,76,0,-23
60,1438,1210,64,62,0,2
60,1450,1160,59,70,0,-11
60,1331,1282,60,58,0,2
60,1442,1377,74,84,0,-10
60,1143,1425,68,76,0,-8
60,1431,1256,55,73,0,-18
60,1397,1281,64,73,0,-9
60,1293,1399,72,63,0,9
60,1295,1102,84,58,0,26
60,1355,1315,85,74,0,11
60,1465,1253,96,75,0,21
60,1469,1213,46,81,0,-35
60,1140,1337,65,54,0,11
60,1211,1334,95,49,0,46
60,1332,1333,64,75,0,-11
60,1456,1180,64,79,0,-15
60,1325,1123,85,77,0,8
60,1110,1259,71,70,0,1
60,1164,1313,81,71,0,10
60,1221,1250,72,75,0,-3
60,1306,1107,71,64,0,7
60,1298,1119,69,62,0,7
60,1105,1380,68,58,0,10
60,1230,1394,72,53,0,19
60,1101,1146,93,58,0,35
60,1248,1131,76,81,0,-5
60,1368,1322,68,73,0,-5
60,1316,1244,68,65,0,3
60,1468,1391,76,65,0,11
60,1290,1102,31,77,0,-46
60,1372,1249,102,72,0,30
60,1106,1108,52,57,0,-5
60,1115,1411,57,66,0,-9
60,1311,1102,86,62,0,24
60,1223,1270,71,74,0,-3
60,1212,1238,61,75,0,-14
60,1466,1239,76,54,0,22
60,1252,1195,71,56,0,15
60,1312,1392,74,65,0,9
61,1318,1241,72,79,0,-7
61,1269,1172,60,69,0,-9
61,1102,1353,70,74,0,-4
61,1423,1174,62,67,0,-5
61,1292,1443,52,68,0,-16
61,1220,1406,74,69,0,5
61,1348,1200,52,42,0,10
61,1187,1102,53,80,0,-27
61,1102,1102,83,79,0,4
61,1461,1305,93,88,0,5
61,1133,1260,56,69,0,-13
61,1274,1323,59,73,0,-14
61,1229,1434,66,70,0,-4
61,1331,1282,76,81,0,-5
61,1102,1361,59,91,0,-32
61,1164,1313,81,77,0,4
61,1306,1107,64,83,0,-19
61,1221,1250,74,82,0,-8
61,1421,1347,76,68,0,8
61,1288,1175,99,83,0,16
61,1312,1392,44,56,0,-12
61,1219,1342,81,57,0,24
61,1205,1149,74,62,0,12
61,1298,1119,78,87,0,-9
61,1248,1131,61,64,0,-3
61,1259,1110,79,81,0,-2
62,1102,1258,50,75,0,-25
62,1232,1356,69,66,0,3
62,1438,1393,81,58,0,23
62,1133,1260,58,65,0,-7
62,1424,1429,59,56,0,3
62,1235,1329,60,81,0,-21
62,1452,1403,88,87,0,1
62,1112,1113,80,67,0,13
62,1421,1347,63,73,0,-10
62,1205,1149,80,71,0,9
62,1219,1342,56,71,0,-15
62,1115,1102,56,73,0,-17
62,1106,1380,66,64,0,2
63,1396,1409,76,67,0,9
63,1232,1356,71,59,0,12
63,1325,1444,81,58,0,23
63,1386,1350,56,79,0,-23
63,1397,1280,56,53,0,3
63,1102,1374,76,72,0,4
63,1275,1405,81,90,0,-9
63,1338,1314,65,75,0,-10
63,1400,1328,79,80,0,-1
63,1103,1185,86,65,0,21
63,1104,1246,70,59,0,11
63,1283,1179,61,68,0,-7
63,1183,1188,74,87,0,-13
63,1163,1139,63,51,0,12
63,1387,1173,71,76,0,-5
63,1120,1281,88,82,0,6
63,1401,1261,66,78,0,-12
63,1181,1210,75,68,0,7
63,1404,1369,69,66,0,3
63,1384,1192,92,94,0,-2
64,1337,1140,76,73,0,3
64,1241,1406,78,63,0,15
64,1247,1348,60,73,0,-13
64,1199,1274,81,59,0,22
64,1200,1182,62,86,0,-24
64,1196,1435,78,71,0,7
64,1440,1441,87,61,0,26
64,1344,1266,72,63,0,9
64,1371,1166,81,85,0,-4
64,1416,1187,71,64,0,7
64,1154,1459,77,69,0,8
64,1376,1208,83,59,0,24
64,1323,1439,51,62,0,-11
64,1326,1336,83,79,0,4
64,1301,1448,72,67,0,5
64,1116,1279,74,59,0,15
64,1177,1385,68,81,0,-13
64,1161,1129,78,56,0,22
64,1124,1243,107,59,0,48
64,1160,1450,70,58,0,12
64,1283,1179,73,78,0,-5
64,1155,1257,54,50,0,4
64,1268,1458,55,61,0,-6
64,1424,1429,74,83,0,-9
64,1245,1132,96,91,0,5
64,1422,1273,81,68,0,13
64,1384,1192,90,82,0,8
64,1322,1102,81,73,0,8
64,1394,1358,70,75,0,-5
64,1311,1270,76,69,0,7
64,1230,1223,57,73,0,-16
64,1101,1372,82,62,0,20
64,1368,1146,69,57,0,12
64,1254,1467,63,68,0,-5
65,1425,1333,75,62,0,13
65,1361,1461,87,57,0,30
65,1102,1431,86,79,0,7
65,1353,1277,67,37,0,30
65,1379,1256,63,76,0,-13
65,1374,1102,67,65,0,2
65,1434,1133,91,85,0,6
65,1242,1395,59,51,0,8
65,1293,1398,73,53,0,20
65,1240,1287,66,85,0,-19
65,1360,1211,62,90,0,-28
65,1404,1183,51,41,0,10
65,1122,1125,76,81,0,-5
65,1369,1188,64,62,0,2
65,1292,1412,59,70,0,-11
65,1102,1451,56,81,0,-25
65,1408,1102,60,83,0,-23
65,1363,1102,59,58,0,1
65,1112,1390,64,73,0,-9
65,1113,1143,72,68,0,4
65,1201,1307,64,62,0,2
65,1457,1421,84,80,0,4
65,1254,1467,78,68,0,10
66,1310,1284,67,77,0,-10
66,1464,1102,75,78,0,-3
66,1402,1102,60,62,0,-2
66,1150,1198,63,55,0,8
66,1297,1227,72,68,0,4
66,1237,1454,73,68,0,5
66,1204,1157,62,79,0,-17
66,1413,1102,51,72,0,-21
66,1236,1324,66,81,0,-15
66,1156,1453,74,68,0,6
66,1142,1169,76,70,0,6
66,1117,1426,83,75,0,8
66,1407,1111,71,62,0,9
66,1138,1325,75,76,0,-1
66,1102,1102,66,62,0,4
66,1389,1264,59,55,0,4
66,1282,1295,67,71,0,-4
66,1377,1303,91,59,0,32
66,1430,1470,73,60,0,13
66,1315,1442,83,81,0,2
66,1460,1352,79,70,0,9
66,1228,1234,80,75,0,5
66,1465,1469,89,74,0,15
66,1213,1308,70,62,0,8
66,1161,1129,77,85,0,-8
66,1167,1168,84,90,0,-6
66,1218,1414,51,53,0,-2
66,1349,1317,74,79,0,-5
66,1319,1294,68,64,0,4
66,1342,1255,45,49,0,-4
66,1457,1421,55,57,0,-2
66,1244,1468,67,84,0,-17
66,1316,1466,78,82,0,-4
66,1239,1251,54,59,0,-5
66,1195,1391,64,63,0,1
66,1205,1219,55,59,0,-4
66,1144,1149,59,58,0,1
67,1328,1104,66,61,0,5
67,1243,1401,61,68,0,-7
67,1181,1155,79,53,0,26
67,1187,1409,68,77,0,-9
67,1207,1344,73,72,0,1
67,1406,1456,74,84,0,-10
67,1433,1247,73,62,0,11
67,1423,1220,73,82,0,-9
67,1265,1373,55,54,0,1
67,1441,1202,69,75,0,-6
67,1452,1196,80,85,0,-5
67,1103,1123,74,42,0,32
67,1275,1444,65,56,0,9
67,1261,1403,71,76,0,-5
67,1281,1395,102,98,0,4
67,1448,1274,66,54,0,12
67,1174,1189,66,43,0,23
67,1382,1206,84,67,0,17
67,1160,1102,74,77,0,-3
67,1371,1437,72,80,0,-8
67,1256,1379,65,62,0,3
67,1102,1451,62,81,0,-19
67,1237,1454,76,83,0,-7
67,1336,1458,81,71,0,10
67,1310,1284,83,74,0,9
67,1124,1120,84,72,0,12
67,1245,1141,83,76,0,7
67,1150,1198,68,65,0,3
67,1210,1199,76,65,0,11
67,1356,1320,62,74,0,-12
67,1329,1116,81,77,0,4
67,1459,1273,72,69,0,3
67,1173,1348,67,56,0,11
67,1190,1154,112,84,0,28
67,1455,1416,93,88,0,5
67,1204,1157,61,58,0,3
67,1464,1102,72,77,0,-5
67,1297,1227,69,67,0,2
67,1112,1143,71,50,0,21
67,1236,1324,75,82,0,-7
67,1117,1426,64,65,0,-1
67,1122,1398,71,56,0,15
67,1132,1405,66,84,0,-18
67,1402,1102,73,74,0,-1
67,1102,1102,65,49,0,16
67,1407,1111,65,59,0,6
67,1399,1287,55,74,0,-19
67,1404,1188,60,76,0,-16
67,1139,1462,55,68,0,-13
67,1280,1235,95,56,0,39
67,1397,1242,80,61,0,19
67,1369,1183,75,44,0,31
67,1363,1102,75,62,0,13
67,1439,1438,65,51,0,14
67,1208,1279,71,61,0,10
67,1417,1333,57,52,0,5
67,1413,1102,86,89,0,-3
67,1460,1352,86,56,0,30
67,1156,1453,73,65,0,8
67,1142,1169,51,64,0,-13
67,1422,1440,76,59,0,17
67,1182,1386,67,50,0,17
67,1201,1307,65,55,0,10
67,1345,1278,81,62,0,19
67,1177,1166,62,69,0,-7
67,1337,1211,75,97,0,-22
67,1389,1264,68,54,0,14
67,1377,1303,97,93,0,4
67,1430,1470,62,70,0,-8
67,1282,1295,49,47,0,2
67,1338,1323,58,84,0,-26
67,1435,1376,93,81,0,12
67,1293,1125,71,72,0,-1
67,1315,1442,87,99,0,-12
67,1213,1308,65,53,0,12
67,1431,1102,69,51,0,18
67,1465,1469,75,79,0,-4
67,1167,1168,83,73,0,10
67,1113,1390,79,75,0,4
67,1361,1461,98,71,0,27
67,1218,1414,62,61,0,1
67,1140,1334,95,87,0,8
67,1298,1259,70,52,0,18
67,1392,1216,57,59,0,-2
67,1102,1357,58,61,0,-3
67,1127,1306,65,44,0,21
67,1250,1137,70,84,0,-14
67,1102,1197,70,58,0,12
67,1221,1159,63,74,0,-11
67,1164,1288,76,79,0,-3
67,1383,1254,88,102,0,-14
67,1342,1255,66,54,0,12
67,1102,1105,79,57,0,22
67,1244,1468,79,84,0,-5
67,1313,1175,94,66,0,28
67,1108,1380,59,76,0,-17
67,1368,1102,79,73,0,6
67,1146,1322,77,81,0,-4
67,1205,1219,69,72,0,-3
67,1316,1466,82,72,0,10
67,1249,1270,64,56,0,8
67,1144,1149,75,67,0,8
67,1239,1251,58,64,0,-6
67,1212,1115,74,71,0,3
67,1238,1290,106,56,0,50
67,1192,1136,81,79,0,2
67,1384,1148,62,59,0,3
67,1195,1391,66,77,0,-11
67,1230,1101,67,75,0,-8
67,1411,1106,80,73,0,7
68,1396,1408,64,81,0,-17
68,1406,1456,74,75,0,-1
68,1423,1220,83,89,0,-6
68,1102,1374,70,48,0,22
68,1326,1277,79,62,0,17
68,1186,1170,68,60,0,8
68,1174,1189,75,70,0,5
68,1241,1180,73,64,0,9
68,1179,1229,78,76,0,2
68,1283,1260,46,72,0,-26
68,1412,1292,63,52,0,11
68,1265,1373,50,63,0,-13
68,1266,1385,73,75,0,-2
68,1191,1434,70,52,0,18
68,1232,1133,60,57,0,3
68,1317,1349,79,53,0,26
68,1356,1320,71,68,0,3
68,1393,1301,76,73,0,3
68,1321,1353,56,64,0,-8
68,1102,1450,62,77,0,-15
68,1305,1424,89,60,0,29
68,1415,1471,71,59,0,12
68,1312,1420,69,65,0,4
68,1392,1216,63,49,0,14
68,1102,1357,76,64,0,12
68,1127,1306,65,71,0,-6
68,1102,1197,67,65,0,2
68,1192,1136,95,84,0,11
68,1384,1148,77,85,0,-8
68,1372,1358,78,68,0,10
68,1137,1250,92,68,0,24
68,1221,1159,60,78,0,-18
69,1441,1154,76,75,0,1
69,1257,1210,74,58,0,16
69,1186,1170,94,79,0,15
69,1188,1122,59,74,0,-15
69,1232,1133,67,55,0,12
69,1274,1181,77,75,0,2
69,1191,1434,58,51,0,7
69,1369,1293,60,77,0,-17
69,1179,1229,95,60,0,35
69,1459,1190,67,62,0,5
69,1102,1416,96,69,0,27
69,1283,1260,50,70,0,-20
69,1403,1328,57,52,0,5
69,1212,1290,85,72,0,13
69,1102,1106,87,63,0,24
69,1411,1105,66,49,0,17
69,1238,1115,63,55,0,8
69,1300,1354,91,77,0,14
70,1323,1448,79,58,0,21
70,1266,1139,70,67,0,3
70,1188,1183,61,70,0,-9
70,1123,1138,58,78,0,-20
70,1120,1208,86,91,0,-5
70,1141,1325,69,83,0,-14
70,1245,1275,77,68,0,9
70,1405,1103,91,76,0,15
70,1234,1277,84,78,0,6
70,1458,1336,72,56,0,16
70,1155,1314,63,50,0,13
70,1235,1452,72,76,0,-4
70,1400,1124,69,83,0,-14
70,1279,1397,52,50,0,2
70,1240,1184,82,86,0,-4
70,1268,1345,61,60,0,1
70,1242,1243,74,51,0,23
70,1116,1280,61,45,0,16
70,1182,1173,69,64,0,5
70,1102,1228,71,75,0,-4
70,1305,1424,72,62,0,10
70,1390,1425,66,72,0,-6
70,1300,1354,64,63,0,1
70,1164,1288,82,95,0,-13
70,1312,1420,71,75,0,-4
71,1241,1189,78,57,0,21
71,1187,1102,82,73,0,9
71,1269,1200,60,54,0,6
71,1196,1376,66,72,0,-6
71,1154,1422,66,85,0,-19
71,1273,1190,64,70,0,-6
71,1441,1151,67,74,0,-7
71,1344,1371,43,60,0,-17
71,1338,1439,83,72,0,11
71,1348,1433,62,63,0,-1
71,1104,1261,78,60,0,18
71,1459,1440,80,84,0,-4
71,1247,1387,82,75,0,7
71,1132,1444,70,76,0,-6
71,1102,1416,75,61,0,14
71,1455,1408,75,67,0,8
71,1395,1329,81,78,0,3
71,1385,1437,70,59,0,11
71,1166,1207,79,86,0,-7
71,1301,1438,57,64,0,-7
71,1409,1374,63,65,0,-2
71,1281,1246,75,70,0,5
71,1394,1372,75,84,0,-9
71,1249,1230,58,67,0,-9
72,1188,1398,68,60,0,8
72,1102,1112,73,58,0,15
72,1287,1293,66,56,0,10
72,1234,1326,85,89,0,-4
72,1102,1140,60,105,0,-45
72,1396,1153,60,63,0,-3
72,1184,1122,79,94,0,-15
72,1183,1125,61,89,0,-28
72,1143,1390,55,70,0,-15
72,1333,1102,91,71,0,20
72,1451,1286,96,88,0,8
72,1102,1186,75,89,0,-14
72,1369,1399,68,64,0,4
72,1404,1240,70,82,0,-12
72,1461,1161,72,74,0,-2
72,1201,1429,53,69,0,-16
72,1353,1278,76,72,0,4
72,1340,1285,64,70,0,-6
72,1332,1450,71,74,0,-3
72,1334,1211,58,76,0,-18
72,1383,1447,67,74,0,-7
72,1467,1384,68,62,0,6
72,1347,1367,63,61,0,2
72,1254,1192,70,78,0,-8
72,1205,1342,59,53,0,6
73,1102,1315,82,85,0,-3
73,1349,1379,88,62,0,26
73,1453,1237,71,80,0,-9
73,1402,1102,57,47,0,10
73,1454,1297,73,87,0,-14
73,1102,1236,82,72,0,10
73,1198,1102,80,87,0,-7
73,1169,1413,80,77,0,3
73,1117,1102,95,87,0,8
73,1330,1267,82,81,0,1
73,1375,1157,71,65,0,6
73,1426,1102,63,56,0,7
73,1336,1268,55,50,0,5
73,1324,1156,72,80,0,-8
73,1352,1464,78,84,0,-6
73,1292,1150,66,65,0,1
73,1173,1206,74,65,0,9
73,1407,1204,68,56,0,12
73,1245,1103,61,72,0,-11
73,1414,1167,70,53,0,17
73,1412,1431,63,51,0,12
73,1227,1460,47,72,0,-25
73,1317,1256,63,68,0,-5
73,1303,1442,77,85,0,-8
73,1295,1331,61,54,0,7
73,1355,1377,56,64,0,-8
73,1308,1465,75,85,0,-10
73,1264,1284,65,70,0,-5
73,1305,1129,74,72,0,2
73,1469,1370,77,76,0,1
73,1218,1142,84,68,0,16
73,1306,1262,69,74,0,-5
73,1383,1447,81,84,0,-3
73,1467,1384,59,54,0,5
73,1347,1367,102,66,0,36
73,1195,1466,86,60,0,26
73,1205,1342,91,64,0,27
74,1139,1177,68,58,0,10
74,1328,1235,79,72,0,7
74,1130,1301,65,81,0,-16
74,1274,1439,76,80,0,-4
74,1163,1371,73,80,0,-7
74,1123,1405,81,67,0,14
74,1281,1104,68,65,0,3
74,1200,1247,76,68,0,8
74,1154,1441,74,63,0,11
74,1158,1406,90,88,0,2
74,1188,1125,62,94,0,-32
74,1260,1191,68,55,0,13
74,1434,1179,77,80,0,-3
74,1102,1315,85,81,0,4
74,1451,1286,82,74,0,8
74,1198,1102,47,90,0,-43
74,1344,1385,81,92,0,-11
74,1155,1393,78,61,0,17
74,1317,1256,57,55,0,2
74,1452,1242,91,79,0,12
74,1102,1187,66,59,0,7
74,1387,1382,70,59,0,11
74,1220,1180,71,73,0,-2
74,1141,1444,65,67,0,-2
74,1287,1122,75,74,0,1
74,1138,1275,88,64,0,24
74,1228,1458,75,60,0,15
74,1229,1283,67,74,0,-7
74,1454,1297,65,79,0,-14
74,1329,1400,75,67,0,8
74,1340,1285,61,56,0,5
74,1186,1102,90,64,0,26
74,1376,1280,59,75,0,-16
74,1424,1102,68,58,0,10
74,1332,1102,86,74,0,12
74,1184,1293,64,76,0,-12
74,1133,1356,74,66,0,8
74,1243,1403,62,73,0,-11
74,1120,1279,84,86,0,-2
74,1438,1338,73,66,0,7
74,1190,1151,65,67,0,-2
74,1345,1321,75,70,0,5
74,1352,1464,66,70,0,-4
74,1404,1399,66,64,0,2
74,1266,1166,68,71,0,-3
74,1292,1150,73,60,0,13
74,1426,1102,58,52,0,6
74,1369,1240,54,66,0,-12
74,1375,1157,70,66,0,4
74,1349,1379,76,68,0,8
74,1453,1237,79,72,0,7
74,1324,1156,78,80,0,-2
74,1183,1398,86,72,0,14
74,1412,1431,75,60,0,15
74,1117,1102,83,77,0,6
74,1402,1102,77,67,0,10
74,1407,1204,64,79,0,-15
74,1102,1236,83,56,0,27
74,1169,1413,63,75,0,-12
74,1208,1435,73,70,0,3
74,1461,1161,59,68,0,-9
74,1333,1450,68,66,0,2
74,1181,1314,87,91,0,-4
74,1202,1459,67,75,0,-8
74,1409,1416,58,65,0,-7
74,1320,1232,57,61,0,-4
74,1277,1304,66,56,0,10
74,1330,1267,67,87,0,-20
74,1246,1397,71,82,0,-11
74,1160,1112,82,79,0,3
74,1348,1269,63,75,0,-12
74,1227,1460,57,77,0,-20
74,1210,1323,82,80,0,2
74,1303,1442,73,75,0,-2
74,1295,1331,74,80,0,-6
74,1355,1377,89,78,0,11
74,1308,1465,97,70,0,27
74,1264,1284,69,71,0,-2
74,1469,1370,56,77,0,-21
74,1425,1417,66,48,0,18
74,1414,1167,57,62,0,-5
74,1218,1142,81,64,0,17
74,1102,1337,70,91,0,-21
74,1306,1262,74,63,0,11
74,1146,1270,70,80,0,-10
74,1394,1230,53,58,0,-5
74,1108,1238,66,74,0,-8
74,1391,1252,61,69,0,-8
74,1468,1239,63,44,0,19
74,1249,1101,62,77,0,-15
74,1106,1115,73,67,0,6
74,1105,1290,93,58,0,35
74,1380,1212,69,72,0,-3
74,1358,1311,78,71,0,7
74,1195,1466,69,60,0,9
74,1411,1410,77,75,0,2
75,1408,1153,61,64,0,-3
75,1102,1234,67,65,0,2
75,1158,1406,66,53,0,13
75,1260,1191,69,58,0,11
75,1434,1179,74,57,0,17
75,1220,1180,79,74,0,5
75,1437,1207,84,74,0,10
75,1229,1283,62,72,0,-10
75,1455,1396,70,67,0,3
75,1320,1232,70,67,0,3
75,1305,1129,73,62,0,11
75,1133,1356,68,69,0,-1
75,1193,1346,63,78,0,-15
75,1390,1143,76,70,0,6
75,1392,1420,65,71,0,-6
75,1214,1219,58,72,0,-14
75,1313,1164,84,72,0,12
75,1259,1248,75,62,0,13
76,1193,1346,77,70,0,7
76,1188,1184,74,78,0,-4
76,1187,1374,56,71,0,-15
76,1202,1422,68,49,0,19
76,1273,1359,89,82,0,7
76,1160,1333,78,49,0,29
76,1404,1122,76,75,0,1
76,1278,1304,79,61,0,18
76,1424,1102,69,64,0,5
76,1268,1326,65,73,0,-8
76,1242,1329,78,66,0,12
76,1361,1363,85,54,0,31
76,1140,1211,71,82,0,-11
76,1392,1420,48,60,0,-12
76,1214,1219,76,71,0,5
76,1367,1205,77,69,0,8
76,1254,1383,96,84,0,12
76,1197,1300,59,50,0,9
76,1248,1259,80,76,0,4
76,1313,1164,64,74,0,-10
76,1394,1101,69,82,0,-13
76,1105,1115,56,55,0,1
76,1108,1212,62,67,0,-5
76,1380,1238,53,57,0,-4
76,1106,1290,65,68,0,-3
77,1209,1375,67,70,0,-3
77,1181,1323,89,93,0,-4
77,1301,1393,68,77,0,-9
77,1376,1104,78,81,0,-3
77,1246,1116,80,81,0,-1
77,1277,1336,60,58,0,2
77,1132,1245,67,71,0,-4
77,1243,1400,77,80,0,-3
77,1435,1120,67,73,0,-6
77,1403,1452,71,82,0,-11
77,1207,1166,48,63,0,-15
77,1395,1235,79,76,0,3
77,1139,1385,76,73,0,3
77,1173,1433,67,76,0,-9
77,1189,1241,61,70,0,-9
77,1382,1247,86,73,0,13
77,1197,1300,60,47,0,13
78,1344,1163,70,59,0,11
78,1422,1202,64,58,0,6
78,1409,1408,48,58,0,-10
78,1362,1337,68,76,0,-8
78,1150,1330,76,78,0,-2
78,1416,1455,60,61,0,-1
78,1234,1353,79,66,0,13
78,1378,1102,65,82,0,-17
78,1154,1190,79,71,0,8
78,1441,1440,74,72,0,2
78,1130,1448,65,69,0,-4
78,1206,1200,77,45,0,32
78,1459,1151,66,78,0,-12
78,1210,1438,49,57,0,-8
78,1434,1133,52,76,0,-24
78,1179,1320,80,59,0,21
78,1397,1208,89,81,0,8
78,1283,1356,65,53,0,12
78,1359,1273,70,77,0,-7
78,1387,1348,67,60,0,7
78,1321,1102,76,79,0,-3
78,1279,1281,80,59,0,21
78,1280,1261,80,94,0,-14
78,1437,1266,96,64,0,32
78,1361,1363,77,55,0,22
78,1304,1458,48,61,0,-13
78,1372,1394,80,68,0,12
78,1358,1368,79,61,0,18
78,1230,1322,67,68,0,-1
78,1249,1311,71,76,0,-5
78,1101,1223,88,59,0,29
79,1334,1102,84,57,0,27
79,1209,1204,79,75,0,4
79,1143,1102,75,76,0,-1
79,1390,1160,51,69,0,-18
79,1426,1402,56,63,0,-7
79,1242,1235,97,64,0,33
79,1286,1186,77,93,0,-16
79,1375,1407,73,70,0,3
79,1285,1451,80,67,0,13
79,1102,1102,66,72,0,-6
79,1112,1333,70,61,0,9
79,1278,1345,71,68,0,3
79,1122,1404,71,50,0,21
79,1240,1183,76,64,0,12
79,1226,1102,69,43,0,26
79,1113,1332,64,75,0,-11
79,1398,1287,66,79,0,-13
79,1125,1184,92,74,0,18
79,1399,1188,63,81,0,-18
79,1102,1201,63,69,0,-6
79,1129,1424,78,66,0,12
79,1102,1425,54,69,0,-15
79,1450,1417,81,73,0,8
79,1447,1192,76,72,0,4
79,1219,1149,77,73,0,4
79,1347,1457,64,80,0,-16
79,1214,1342,70,85,0,-15
79,1255,1205,57,54,0,3
79,1102,1254,66,60,0,6
79,1144,1367,72,71,0,1
79,1384,1383,67,70,0,-3
79,1148,1467,46,62,0,-16
80,1237,1227,89,69,0,20
80,1346,1145,67,74,0,-7
80,1464,1236,84,70,0,14
80,1453,1297,86,82,0,4
80,1233,1264,85,67,0,18
80,1267,1292,107,79,0,28
80,1413,1253,68,66,0,2
80,1416,1408,53,49,0,4
80,1102,1194,84,80,0,4
80,1352,1324,88,82,0,6
80,1460,1454,92,81,0,11
80,1415,1414,86,65,0,21
80,1275,1103,76,83,0,-7
80,1433,1382,67,64,0,3
80,1167,1471,76,71,0,5
80,1256,1412,70,58,0,12
80,1442,1102,75,69,0,6
80,1379,1317,49,65,0,-16
80,1443,1349,77,71,0,6
80,1282,1303,62,52,0,10
80,1430,1469,87,72,0,15
80,1117,1102,73,62,0,11
80,1155,1210,74,72,0,2
80,1304,1228,72,77,0,-5
80,1156,1102,83,89,0,-6
80,1431,1198,75,59,0,16
80,1370,1308,83,72,0,11
80,1218,1102,50,59,0,-9
80,1153,1396,71,69,0,2
80,1293,1369,80,60,0,20
80,1138,1444,86,54,0,32
80,1214,1342,62,57,0,5
80,1102,1254,64,46,0,18
80,1384,1383,80,66,0,14
80,1255,1205,78,71,0,7
80,1244,1391,61,74,0,-13
80,1219,1149,68,69,0,-1
80,1251,1316,73,61,0,12
80,1144,1367,64,49,0,15
80,1347,1457,47,55,0,-8
80,1239,1252,66,60,0,6
80,1107,1262,71,79,0,-8
80,1148,1467,52,72,0,-20
80,1466,1468,64,66,0,-2
81,1462,1163,72,80,0,-8
81,1199,1448,92,85,0,7
81,1237,1227,88,81,0,7
81,1329,1243,67,60,0,7
81,1326,1102,78,59,0,19
81,1151,1154,70,66,0,4
81,1179,1260,54,81,0,-27
81,1440,1359,85,56,0,29
81,1452,1328,90,91,0,-1
81,1346,1145,70,89,0,-19
81,1158,1189,71,53,0,18
81,1406,1318,67,76,0,-9
81,1246,1120,82,80,0,2
81,1280,1435,51,72,0,-21
81,1207,1139,78,63,0,15
81,1273,1422,74,77,0,-3
81,1405,1132,81,88,0,-7
81,1202,1441,88,70,0,18
81,1112,1332,61,63,0,-2
81,1245,1296,80,58,0,22
81,1226,1102,64,58,0,6
81,1241,1220,93,89,0,4
81,1261,1397,78,65,0,13
81,1400,1395,70,55,0,15
81,1393,1130,75,67,0,8
81,1286,1186,69,85,0,-16
81,1277,1234,58,88,0,-30
81,1102,1201,64,67,0,-3
81,1460,1454,92,82,0,10
81,1235,1242,50,64,0,-14
81,1315,1377,85,76,0,9
81,1104,1208,115,82,0,33
81,1200,1387,40,68,0,-28
81,1267,1292,96,85,0,11
81,1330,1150,64,45,0,19
81,1102,1194,86,75,0,11
81,1190,1459,71,49,0,22
81,1356,1229,55,80,0,-25
81,1301,1181,53,69,0,-16
81,1281,1116,81,86,0,-5
81,1256,1412,69,64,0,5
81,1285,1451,82,91,0,-9
81,1389,1193,50,55,0,-5
81,1353,1321,64,50,0,14
81,1166,1437,86,70,0,16
81,1399,1183,80,67,0,13
81,1102,1102,72,88,0,-16
81,1379,1317,56,68,0,-12
81,1398,1184,73,93,0,-20
81,1125,1287,73,58,0,15
81,1122,1369,78,63,0,15
81,1240,1188,80,60,0,20
81,1352,1324,81,86,0,-5
81,1464,1236,72,70,0,2
81,1453,1297,66,71,0,-5
81,1233,1264,70,77,0,-7
81,1402,1426,79,68,0,11
81,1407,1375,51,58,0,-7
81,1438,1314,60,48,0,12
81,1283,1133,80,58,0,22
81,1362,1211,61,100,0,-39
81,1443,1349,89,66,0,23
81,1376,1279,74,81,0,-7
81,1102,1117,65,67,0,-2
81,1258,1334,80,76,0,4
81,1156,1102,71,64,0,7
81,1413,1253,78,76,0,2
81,1167,1471,65,50,0,15
81,1102,1417,61,64,0,-3
81,1320,1434,57,70,0,-13
81,1177,1344,47,57,0,-10
81,1450,1425,65,76,0,-11
81,1442,1102,82,75,0,7
81,1337,1388,60,58,0,2
81,1282,1303,55,47,0,8
81,1331,1355,103,86,0,17
81,1430,1469,89,93,0,-4
81,1293,1404,84,55,0,29
81,1431,1198,77,68,0,9
81,1370,1308,58,65,0,-7
81,1129,1424,61,59,0,2
81,1143,1160,71,62,0,9
81,1218,1102,74,81,0,-7
81,1390,1102,73,66,0,7
81,1415,1414,67,73,0,-6
81,1465,1170,83,71,0,12
81,1216,1312,57,67,0,-10
81,1221,1131,82,65,0,17
81,1288,1313,69,74,0,-5
81,1436,1392,86,78,0,8
81,1119,1159,74,84,0,-10
81,1107,1262,81,69,0,12
81,1248,1259,97,94,0,3
81,1244,1391,83,75,0,8
81,1251,1316,80,60,0,20
81,1290,1108,56,70,0,-14
81,1106,1105,72,58,0,14
81,1239,1252,69,71,0,-2
81,1223,1249,80,75,0,5
81,1358,1146,97,57,0,40
81,1115,1380,71,73,0,-2
81,1212,1411,73,75,0,-2
81,1466,1468,63,87,0,-24
81,1192,1447,86,95,0,-9
81,1322,1270,69,66,0,3
81,1368,1311,84,86,0,-2
81,1101,1394,83,55,0,28
82,1153,1416,69,68,0,1
82,1158,1189,55,66,0,-11
82,1406,1318,68,57,0,11
82,1458,1276,59,67,0,-8
82,1241,1220,74,70,0,4
82,1378,1408,59,62,0,-3
82,1336,1304,61,62,0,-1
82,1179,1260,29,25,0,4
82,1371,1266,57,51,0,6
82,1465,1170,69,70,0,-1
82,1315,1377,85,81,0,4
82,1283,1133,72,57,0,15
82,1356,1229,59,49,0,10
82,1210,1338,71,65,0,6
82,1191,1232,70,76,0,-6
82,1389,1193,66,49,0,17
82,1331,1355,80,95,0,-15
82,1323,1274,71,61,0,10
82,1268,1278,72,59,0,13
82,1113,1333,75,73,0,2
82,1320,1434,74,60,0,14
82,1436,1392,61,57,0,4
82,1216,1312,75,61,0,14
82,1288,1313,65,68,0,-3
82,1131,1221,86,68,0,18
82,1259,1248,88,69,0,19
82,1119,1159,83,92,0,-9
83,1188,1293,57,86,0,-29
83,1199,1438,81,60,0,21
83,1151,1190,53,51,0,2
83,1450,1102,63,65,0,-2
83,1399,1184,72,83,0,-11
83,1102,1372,79,89,0,-10
83,1255,1214,83,73,0,10
83,1342,1367,75,65,0,10
84,1103,1296,81,76,0,5
84,1329,1235,76,58,0,18
84,1163,1344,73,61,0,12
84,1208,1281,80,70,0,10
84,1348,1173,91,89,0,2
84,1123,1132,62,75,0,-13
84,1444,1245,69,76,0,-7
84,1345,1277,75,65,0,10
84,1409,1396,72,66,0,6
84,1116,1196,75,64,0,11
84,1405,1275,87,75,0,12
84,1369,1122,86,81,0,5
84,1268,1304,64,50,0,14
84,1385,1462,93,84,0,9
84,1365,1258,73,76,0,-3
84,1228,1321,73,66,0,7
84,1387,1247,78,57,0,21
84,1192,1383,75,83,0,-8
84,1102,1447,39,61,0,-22
85,1346,1233,74,70,0,4
85,1338,1301,73,74,0,-1
85,1232,1191,87,73,0,14
85,1139,1266,57,73,0,-16
85,1202,1359,78,64,0,14
85,1416,1378,81,65,0,16
85,1433,1350,68,56,0,12
85,1151,1441,89,81,0,8
85,1440,1422,88,77,0,11
85,1190,1273,64,71,0,-7
85,1435,1246,78,82,0,-4
85,1459,1154,81,67,0,14
85,1268,1304,79,71,0,8
85,1425,1113,89,71,0,18
85,1260,1434,54,52,0,2
85,1320,1179,69,77,0,-8
85,1243,1242,41,59,0,-18
85,1307,1461,74,83,0,-9
85,1371,1177,60,52,0,8
85,1448,1181,60,84,0,-24
85,1129,1429,79,70,0,9
85,1102,1278,82,72,0,10
85,1356,1283,53,68,0,-15
85,1397,1376,93,73,0,20
85,1314,1318,82,62,0,20
85,1102,1447,55,57,0,-2
85,1221,1131,69,78,0,-9
85,1148,1357,70,82,0,-12
85,1192,1383,87,90,0,-3
85,1347,1205,57,69,0,-12
86,1455,1102,68,63,0,5
86,1458,1234,62,77,0,-15
86,1133,1229,71,88,0,-17
86,1336,1326,82,92,0,-10
86,1334,1140,52,80,0,-28
86,1125,1240,63,59,0,4
86,1293,1183,59,68,0,-9
86,1122,1188,79,57,0,22
86,1333,1102,74,56,0,18
86,1381,1170,88,69,0,19
86,1365,1360,60,71,0,-11
86,1276,1353,71,64,0,7
86,1417,1112,74,60,0,14
86,1451,1319,92,59,0,33
86,1398,1399,91,86,0,5
86,1362,1258,63,68,0,-5
86,1211,1388,87,65,0,22
86,1404,1184,72,89,0,-17
86,1186,1285,90,76,0,14
86,1201,1361,53,67,0,-14
86,1340,1102,84,64,0,20
86,1450,1143,82,51,0,31
86,1332,1160,60,56,0,4
86,1102,1390,61,79,0,-18
86,1342,1367,51,65,0,-14
86,1214,1144,57,76,0,-19
86,1347,1205,49,77,0,-28
86,1149,1255,62,70,0,-8
86,1420,1436,71,80,0,-9
86,1219,1457,70,76,0,-6
87,1193,1145,69,80,0,-11
87,1464,1237,70,72,0,-2
87,1454,1324,81,85,0,-4
87,1111,1375,63,65,0,-2
87,1209,1407,80,66,0,14
87,1297,1460,81,75,0,6
87,1102,1352,85,74,0,11
87,1253,1142,64,60,0,4
87,1233,1284,91,86,0,5
87,1198,1379,72,85,0,-13
87,1169,1218,74,75,0,-1
87,1236,1156,75,68,0,7
87,1173,1387,76,53,0,23
87,1123,1103,79,88,0,-9
87,1412,1330,76,69,0,7
87,1389,1265,59,54,0,5
87,1282,1102,68,57,0,11
87,1303,1315,72,62,0,10
87,1168,1414,78,89,0,-11
87,1227,1453,61,58,0,3
87,1471,1415,75,81,0,-6
87,1295,1355,67,68,0,-1
87,1213,1465,71,61,0,10
87,1308,1430,66,69,0,-3
87,1307,1461,67,79,0,-12
87,1138,1405,70,80,0,-10
87,1469,1470,59,77,0,-18
87,1363,1424,60,76,0,-16
87,1129,1429,81,77,0,4
87,1102,1167,71,66,0,5
87,1420,1436,66,55,0,11
87,1214,1144,68,73,0,-5
87,1149,1255,58,64,0,-6
87,1219,1457,63,71,0,-8
87,1391,1239,91,75,0,16
87,1252,1244,76,62,0,14
88,1102,1277,71,78,0,-7
88,1274,1210,60,87,0,-27
88,1310,1373,64,62,0,2
88,1408,1416,81,84,0,-3
88,1386,1247,91,82,0,9
88,1437,1163,68,60,0,8
88,1441,1459,56,80,0,-24
88,1154,1440,75,74,0,1
88,1397,1246,55,70,0,-15
88,1104,1435,82,78,0,4
88,1273,1202,60,70,0,-10
88,1381,1170,77,57,0,20
88,1376,1281,78,93,0,-15
88,1245,1185,64,51,0,13
88,1451,1319,74,52,0,22
88,1448,1301,62,80,0,-18
88,1393,1323,75,67,0,8
88,1242,1403,67,61,0,6
88,1456,1189,54,75,0,-21
88,1285,1186,76,90,0,-14
88,1433,1206,76,79,0,-3
88,1258,1140,71,88,0,-17
88,1400,1452,82,84,0,-2
88,1102,1340,40,71,0,-31
88,1278,1228,63,94,0,-31
88,1196,1208,70,63,0,7
88,1346,1351,80,64,0,16
88,1261,1120,104,80,0,24
88,1111,1375,54,56,0,-2
88,1209,1407,65,53,0,12
88,1102,1334,58,80,0,-22
88,1450,1390,85,76,0,9
88,1412,1330,58,65,0,-7
88,1338,1199,72,79,0,-7
88,1377,1331,86,84,0,2
88,1350,1182,79,72,0,7
88,1398,1240,76,77,0,-1
88,1193,1145,66,53,0,13
88,1122,1183,69,76,0,-7
88,1102,1352,80,61,0,19
88,1125,1399,90,66,0,24
88,1464,1237,77,70,0,7
88,1297,1460,71,77,0,-6
88,1236,1156,55,67,0,-12
88,1395,1243,54,62,0,-8
88,1422,1151,60,55,0,5
88,1454,1324,89,87,0,2
88,1404,1287,69,79,0,-10
88,1207,1371,81,75,0,6
88,1369,1184,94,72,0,22
88,1314,1257,99,54,0,45
88,1425,1112,72,81,0,-9
88,1296,1275,64,69,0,-5
88,1365,1337,86,82,0,4
88,1235,1328,56,66,0,-10
88,1279,1280,56,66,0,-10
88,1304,1345,58,75,0,-17
88,1169,1218,88,80,0,8
88,1233,1284,88,65,0,23
88,1253,1142,74,69,0,5
88,1201,1361,57,75,0,-18
88,1385,1177,83,88,0,-5
88,1333,1160,57,61,0,-4
88,1389,1265,50,51,0,-1
88,1181,1438,66,65,0,1
88,1303,1315,69,81,0,-12
88,1168,1414,67,64,0,3
88,1227,1453,59,69,0,-10
88,1282,1102,80,69,0,11
88,1211,1360,106,69,0,37
88,1471,1415,83,82,0,1
88,1293,1188,89,62,0,27
88,1295,1355,84,82,0,2
88,1213,1465,62,65,0,-3
88,1332,1102,67,64,0,3
88,1308,1430,67,60,0,7
88,1469,1470,64,48,0,16
88,1102,1167,63,44,0,19
88,1417,1113,80,79,0,1
88,1102,1143,62,51,0,11
88,1110,1298,60,72,0,-12
88,1262,1306,67,69,0,-2
88,1159,1131,82,72,0,10
88,1250,1259,47,75,0,-28
88,1192,1102,76,71,0,5
88,1119,1221,69,65,0,4
88,1107,1392,43,59,0,-16
88,1136,1467,60,58,0,2
88,1312,1127,63,76,0,-13
88,1197,1102,71,57,0,14
88,1383,1357,88,76,0,12
88,1391,1239,82,86,0,-4
88,1394,1249,77,68,0,9
88,1311,1146,79,68,0,11
88,1254,1148,87,74,0,13
88,1447,1384,67,52,0,15
88,1252,1244,77,63,0,14
89,1102,1348,78,70,0,8
89,1310,1373,66,68,0,-2
89,1326,1276,87,92,0,-5
89,1102,1153,90,52,0,38
89,1157,1204,65,55,0,10
89,1346,1351,93,68,0,25
89,1396,1378,76,83,0,-7
89,1353,1268,59,68,0,-9
89,1382,1172,69,58,0,11
89,1363,1424,64,67,0,-3
89,1179,1191,85,71,0,14
89,1102,1102,78,66,0,12
89,1234,1336,74,68,0,6
89,1356,1434,65,66,0,-1
89,1321,1458,51,68,0,-17
89,1462,1139,63,51,0,12
89,1159,1131,78,63,0,15
89,1107,1392,67,59,0,8
89,1192,1102,61,74,0,-13
89,1383,1357,82,88,0,-6
89,1312,1127,58,72,0,-14
89,1221,1119,67,51,0,16
89,1197,1102,63,70,0,-7
89,1467,1136,60,76,0,-16
89,1254,1148,81,79,0,2
89,1447,1384,70,68,0,2
89,1259,1250,72,76,0,-4
89,1110,1298,60,69,0,-9
89,1411,1102,75,77,0,-2
90,1369,1184,65,87,0,-22
90,1102,1102,68,64,0,4
90,1441,1422,56,77,0,-21
90,1188,1287,48,56,0,-8
90,1388,1337,66,61,0,5
90,1102,1426,76,74,0,2
90,1179,1191,74,63,0,11
90,1273,1154,88,52,0,36
90,1181,1393,85,71,0,14
90,1356,1434,67,64,0,3
90,1189,1456,73,54,0,19
90,1117,1402,52,57,0,-5
90,1425,1332,72,58,0,14
90,1329,1403,74,69,0,5
90,1102,1307,65,73,0,-8
90,1238,1212,63,59,0,4
90,1367,1205,58,69,0,-11
90,1322,1223,86,80,0,6
90,1394,1368,75,78,0,-3
90,1102,1146,88,63,0,25
90,1249,1358,71,77,0,-6
90,1108,1105,65,52,0,13
90,1380,1106,75,66,0,9
90,1342,1149,77,78,0,-1
90,1251,1466,74,54,0,20
91,1325,1103,90,73,0,17
91,1360,1334,67,77,0,-10
91,1209,1111,85,71,0,14
91,1141,1275,54,96,0,-42
91,1296,1138,74,102,0,-28
91,1350,1269,79,65,0,14
91,1433,1387,67,65,0,2
91,1277,1228,81,72,0,9
91,1395,1452,66,74,0,-8
91,1208,1261,91,78,0,13
91,1439,1210,53,69,0,-16
91,1257,1323,69,57,0,12
91,1185,1132,69,82,0,-13
91,1437,1385,81,58,0,23
91,1124,1235,77,72,0,5
91,1304,1336,83,86,0,-3
91,1113,1102,97,64,0,33
91,1207,1163,57,70,0,-13
91,1243,1328,62,57,0,5
91,1120,1196,57,74,0,-17
91,1281,1279,53,60,0,-7
91,1400,1242,75,72,0,3
91,1251,1466,74,54,0,20
91,1144,1219,68,48,0,20
91,1102,1115,72,56,0,16
91,1411,1290,82,45,0,37
92,1123,1245,90,71,0,19
92,1448,1155,39,60,0,-21
92,1172,1382,53,56,0,-3
92,1386,1173,97,84,0,13
92,1206,1102,63,58,0,5
92,1102,1307,62,55,0,7
92,1438,1301,61,68,0,-7
92,1202,1154,72,63,0,9
92,1422,1441,80,81,0,-1
92,1273,1151,81,77,0,4
92,1378,1396,47,65,0,-18
92,1280,1376,69,48,0,21
92,1139,1371,61,52,0,9
92,1247,1182,85,65,0,20
92,1314,1266,70,83,0,-13
92,1353,1102,74,63,0,11
92,1102,1408,61,46,0,15
92,1381,1319,85,80,0,5
92,1274,1199,71,88,0,-17
92,1166,1177,77,53,0,24
92,1344,1462,83,68,0,15
92,1409,1153,69,70,0,-1
92,1116,1104,81,66,0,15
92,1435,1397,58,70,0,-12
92,1424,1201,64,67,0,-3
92,1380,1105,73,57,0,16
92,1300,1102,63,79,0,-16
92,1313,1175,86,55,0,31
92,1255,1214,68,74,0,-6
92,1131,1221,75,86,0,-11
92,1259,1110,60,49,0,11
92,1322,1372,57,83,0,-26
92,1394,1102,61,69,0,-8
92,1230,1249,45,67,0,-22
92,1368,1270,91,96,0,-5
92,1311,1223,83,68,0,15
92,1101,1358,86,72,0,14
92,1108,1106,68,59,0,9
93,1444,1275,66,74,0,-8
93,1325,1185,86,67,0,19
93,1138,1141,85,73,0,12
93,1188,1404,66,53,0,13
93,1276,1234,79,57,0,22
93,1113,1102,80,72,0,8
93,1287,1398,74,60,0,14
93,1211,1365,89,75,0,14
93,1228,1304,86,70,0,16
93,1102,1443,81,57,0,24
93,1184,1125,81,67,0,14
93,1102,1417,61,76,0,-15
93,1183,1369,88,94,0,-6
93,1294,1340,66,64,0,2
93,1240,1293,87,74,0,13
93,1170,1451,73,82,0,-9
93,1399,1122,81,76,0,5
93,1277,1326,71,67,0,4
93,1140,1362,79,73,0,6
93,1390,1332,68,71,0,-3
93,1160,1425,80,62,0,18
93,1226,1285,58,64,0,-6
93,1337,1258,74,81,0,-7
93,1278,1321,59,67,0,-8
93,1361,1129,78,66,0,12
93,1143,1333,57,59,0,-2
93,1112,1450,69,53,0,16
93,1388,1334,58,46,0,12
93,1102,1352,83,73,0,10
93,1464,1227,74,58,0,16
93,1453,1236,84,89,0,-5
93,1454,1237,84,72,0,12
93,1467,1383,71,84,0,-13
93,1148,1447,63,83,0,-20
93,1136,1254,87,80,0,7
93,1384,1102,65,72,0,-7
93,1357,1192,69,82,0,-13
93,1354,1197,67,75,0,-8
93,1102,1290,82,62,0,20
93,1411,1115,79,65,0,14
94,1153,1408,91,71,0,20
94,1389,1351,66,52,0,14
94,1241,1180,78,84,0,-6
94,1373,1264,74,69,0,5
94,1402,1102,58,49,0,9
94,1142,1413,61,69,0,-8
94,1204,1111,78,84,0,-6
94,1102,1303,76,80,0,-4
94,1382,1102,88,41,0,47
94,1319,1381,62,92,0,-30
94,1387,1350,72,67,0,5
94,1133,1179,71,80,0,-9
94,1267,1317,65,77,0,-12
94,1330,1292,67,61,0,6
94,1426,1117,73,71,0,2
94,1407,1157,59,75,0,-16
94,1191,1283,81,90,0,-9
94,1102,1412,57,64,0,-7
94,1336,1345,52,73,0,-21
94,1434,1232,43,58,0,-15
94,1103,1132,71,83,0,-12
94,1102,1286,74,69,0,5
94,1414,1471,80,55,0,25
94,1256,1349,101,57,0,44
94,1102,1102,61,66,0,-5
94,1379,1194,60,69,0,-9
94,1430,1410,78,74,0,4
94,1470,1308,51,78,0,-27
94,1355,1282,67,49,0,18
94,1229,1320,56,70,0,-14
94,1260,1356,60,52,0,8
94,1429,1305,75,72,0,3
94,1375,1209,81,84,0,-3
94,1370,1213,63,57,0,6
94,1167,1169,84,58,0,26
94,1415,1102,68,72,0,-4
94,1424,1201,68,67,0,1
94,1218,1253,78,76,0,2
94,1391,1316,74,79,0,-5
94,1148,1447,83,77,0,6
94,1467,1383,75,67,0,8
94,1136,1254,63,60,0,3
94,1357,1192,70,64,0,6
94,1244,1195,80,63,0,17
95,1210,1393,84,77,0,7
95,1120,1397,77,72,0,5
95,1403,1400,68,59,0,9
95,1102,1276,57,73,0,-16
95,1177,1207,60,68,0,-8
95,1441,1273,85,61,0,24
95,1185,1296,91,57,0,34
95,1123,1141,97,91,0,6
95,1208,1376,70,91,0,-21
95,1226,1285,58,59,0,-1
95,1170,1451,70,72,0,-2
95,1130,1323,94,90,0,4
95,1458,1228,69,74,0,-5
95,1267,1317,73,72,0,1
95,1112,1102,75,74,0,1
95,1325,1138,66,86,0,-20
95,1172,1433,65,57,0,8
95,1155,1274,66,58,0,8
95,1116,1261,83,75,0,8
95,1256,1349,79,58,0,21
95,1294,1340,65,73,0,-8
95,1163,1266,80,62,0,18
95,1204,1111,65,57,0,8
95,1328,1329,90,94,0,-4
95,1435,1279,75,70,0,5
95,1439,1448,84,46,0,38
95,1161,1102,72,49,0,23
95,1287,1125,74,74,0,0
95,1190,1422,74,85,0,-11
95,1314,1199,78,70,0,8
95,1102,1412,96,79,0,17
95,1452,1243,65,43,0,22
95,1246,1196,67,71,0,-4
95,1360,1337,84,90,0,-6
95,1361,1129,62,58,0,4
95,1143,1332,63,74,0,-11
95,1206,1247,89,54,0,35
95,1275,1245,51,64,0,-13
95,1377,1295,80,71,0,9
95,1462,1166,77,69,0,8
95,1405,1444,91,44,0,47
95,1183,1404,68,73,0,-5
95,1379,1194,66,73,0,-7
95,1240,1122,75,67,0,8
95,1426,1117,64,56,0,8
95,1102,1102,69,59,0,10
95,1402,1102,61,57,0,4
95,1407,1157,71,76,0,-5
95,1142,1413,66,68,0,-2
95,1331,1442,85,81,0,4
95,1431,1150,70,47,0,23
95,1229,1320,87,94,0,-7
95,1260,1356,65,58,0,7
95,1188,1369,63,69,0,-6
95,1235,1395,72,76,0,-4
95,1181,1257,73,80,0,-7
95,1102,1303,76,80,0,-4
95,1423,1189,77,80,0,-3
95,1434,1232,70,58,0,12
95,1280,1104,59,64,0,-5
95,1390,1333,62,73,0,-11
95,1373,1264,64,56,0,8
95,1182,1348,86,75,0,11
95,1330,1292,73,60,0,13
95,1184,1398,89,84,0,5
95,1459,1202,74,73,0,1
95,1375,1209,73,82,0,-9
95,1191,1283,72,63,0,9
95,1304,1278,78,74,0,4
95,1133,1179,67,61,0,6
95,1414,1471,75,64,0,11
95,1102,1425,71,61,0,10
95,1242,1124,71,58,0,13
95,1389,1351,65,78,0,-13
95,1430,1410,73,64,0,9
95,1470,1308,64,55,0,9
95,1355,1282,88,77,0,11
95,1113,1450,77,74,0,3
95,1399,1293,71,61,0,10
95,1370,1213,71,81,0,-10
95,1415,1102,68,52,0,16
95,1160,1417,70,61,0,9
95,1218,1253,79,76,0,3
95,1167,1169,87,90,0,-3
95,1140,1388,65,51,0,14
95,1211,1258,86,69,0,17
95,1334,1362,76,69,0,7
95,1259,1298,67,73,0,-6
95,1468,1251,78,94,0,-16
95,1137,1110,71,78,0,-7
95,1391,1316,85,68,0,17
95,1354,1197,63,57,0,6
95,1119,1131,63,75,0,-12
95,1466,1252,73,66,0,7
95,1248,1250,75,69,0,6
95,1322,1368,79,61,0,18
95,1249,1372,88,83,0,5
95,1380,1108,89,75,0,14
95,1106,1411,76,86,0,-10
95,1105,1102,54,55,0,-1
95,1146,1101,84,82,0,2
95,1102,1311,101,105,0,-4
95,1175,1164,68,81,0,-13
95,1102,1300,55,53,0,2
95,1290,1238,54,68,0,-14
95,1270,1223,85,58,0,27
95,1262,1392,64,62,0,2
95,1216,1127,77,60,0,17
95,1107,1312,76,66,0,10
95,1214,1342,67,65,0,2
95,1219,1367,65,60,0,5
96,1139,1437,73,61,0,12
96,1153,1102,74,80,0,-6
96,1268,1277,73,55,0,18
96,1443,1198,91,58,0,33
96,1431,1150,77,62,0,15
96,1102,1286,61,71,0,-10
96,1326,1234,57,73,0,-16
96,1265,1346,76,67,0,9
96,1301,1338,65,62,0,3
96,1102,1378,98,52,0,46
96,1377,1295,77,89,0,-12
96,1331,1442,95,59,0,36
96,1429,1305,87,66,0,21
96,1354,1197,58,63,0,-5
96,1119,1131,57,55,0,2
96,1298,1259,66,58,0,8
96,1110,1137,81,68,0,13
96,1175,1164,74,94,0,-20
96,1250,1248,70,71,0,-1
96,1306,1262,64,72,0,-8
96,1216,1107,83,77,0,6
97,1443,1198,71,59,0,12
97,1382,1173,52,55,0,-3
97,1350,1386,73,76,0,-3
97,1387,1269,78,57,0,21
97,1265,1346,65,52,0,13
97,1438,1274,62,51,0,11
97,1393,1314,72,70,0,2
97,1304,1353,72,51,0,21
97,1332,1112,80,69,0,11
97,1329,1328,79,75,0,4
97,1161,1102,74,44,0,30
97,1146,1372,66,79,0,-13
97,1311,1322,87,71,0,16
97,1249,1394,66,47,0,19
97,1230,1102,72,88,0,-16
97,1223,1358,70,83,0,-13
97,1105,1411,58,68,0,-10
97,1290,1212,67,63,0,4
97,1106,1102,67,70,0,-3
97,1347,1214,67,52,0,15
97,1457,1219,83,54,0,29
97,1421,1255,61,77,0,-16
97,1144,1205,63,57,0,6
97,1238,1115,64,58,0,6
98,1308,1410,69,51,0,18
98,1138,1103,80,78,0,2
98,1141,1405,81,79,0,2
98,1452,1124,89,94,0,-5
98,1338,1448,70,57,0,13
98,1376,1116,73,101,0,-28
98,1235,1400,67,81,0,-14
98,1403,1395,69,49,0,20
98,1207,1462,72,66,0,6
98,1416,1409,73,69,0,4
98,1123,1185,100,65,0,35
98,1104,1120,70,58,0,12
98,1132,1275,79,84,0,-5
98,1296,1444,63,73,0,-10
98,1276,1228,53,76,0,-23
98,1129,1201,64,67,0,-3
98,1210,1181,81,77,0,4
98,1277,1102,64,58,0,6
98,1261,1435,83,68,0,15
98,1378,1102,52,73,0,-21
98,1345,1458,73,69,0,4
98,1177,1266,71,77,0,-6
98,1279,1246,70,62,0,8
98,1156,1236,108,104,0,4
98,1297,1102,70,69,0,1
98,1460,1454,92,94,0,-2
98,1324,1464,87,83,0,4
98,1447,1467,74,67,0,7
99,1393,1155,64,54,0,10
99,1408,1455,70,78,0,-8
99,1371,1163,58,69,0,-11
99,1196,1281,70,72,0,-2
99,1336,1278,84,65,0,19
99,1385,1344,81,67,0,14
99,1323,1301,69,80,0,-11
99,1102,1333,70,75,0,-5
99,1161,1307,87,73,0,14
99,1437,1166,72,60,0,12
99,1401,1280,57,63,0,-6
99,1332,1417,82,74,0,8
99,1321,1268,60,55,0,5
99,1199,1130,93,64,0,29
99,1424,1361,62,71,0,-9
99,1186,1226,63,68,0,-5
99,1425,1390,79,42,0,37
99,1247,1386,66,72,1,-6
99,1102,1200,53,49,1,4
99,1125,1188,78,61,1,17
99,1287,1369,61,54,1,7
99,1447,1467,64,59,0,5
99,1300,1197,58,65,0,-7
99,1358,1394,84,61,0,23
99,1102,1322,92,83,0,9
99,1146,1368,88,71,0,17
99,1223,1230,72,67,0,5
99,1372,1101,61,63,0,-2
99,1131,1250,69,58,0,11
100,1351,1284,74,77,0,-3
100,1346,1389,65,60,0,5
100,1264,1193,69,59,0,10
100,1194,1292,80,50,0,30
100,1124,1329,81,70,0,11
100,1276,1277,69,50,0,19
100,1452,1395,76,67,0,9
100,1373,1145,73,66,0,7
100,1153,1435,64,78,0,-14
100,1403,1235,81,54,0,27
100,1242,1431,67,62,0,5
100,1160,1113,75,61,0,14
100,1234,1304,102,64,0,38
100,1328,1400,65,69,0,-4
100,1451,1294,60,59,0,1
100,1187,1416,60,64,0,-4
100,1429,1461,72,59,0,13
100,1340,1381,58,68,0,-10
100,1350,1182,62,67,0,-5
100,1269,1386,100,66,0,34
100,1173,1348,84,72,0,12
100,1206,1102,73,59,0,14
100,1133,1356,63,73,1,-10
100,1320,1229,65,60,1,5
100,1240,1293,68,65,1,3
100,1184,1122,70,67,1,3
100,1362,1360,67,51,1,16
100,1365,1102,95,86,1,9
100,1300,1197,74,71,0,3
100,1270,1311,67,80,0,-13
100,1411,1108,80,78,0,2
100,1102,1380,68,61,0,7
100,1212,1106,91,68,0,23
100,1238,1105,50,35,0,15
100,1251,1244,69,59,0,10
100,1316,1466,60,68,0,-8
100,1252,1195,60,72,0,-12
100,1468,1391,70,73,0,-3
100,1347,1144,60,78,0,-18
100,1457,1255,82,61,0,21
101,1186,1226,75,62,0,13
101,1346,1389,64,66,0,-2
101,1351,1284,62,65,0,-3
101,1141,1296,74,79,0,-5
101,1138,1245,81,67,0,14
101,1264,1193,67,85,0,-18
101,1274,1130,80,76,0,4
101,1194,1292,63,54,0,9
101,1413,1218,68,73,0,-5
101,1373,1145,75,76,0,-1
101,1405,1123,89,70,0,19
101,1169,1415,68,72,0,-4
101,1444,1185,63,64,0,-1
101,1253,1414,68,71,0,-3
101,1267,1150,75,67,0,8
101,1448,1210,63,75,0,-12
101,1102,1142,71,57,0,14
101,1317,1412,51,65,0,-14
101,1443,1330,69,71,0,-2
101,1410,1470,47,65,0,-18
101,1471,1168,89,85,0,4
101,1213,1430,55,59,0,-4
101,1465,1370,79,80,0,-1
101,1469,1308,66,76,0,-10
101,1305,1161,85,82,0,3
101,1382,1182,75,59,0,16
101,1387,1269,86,72,0,14
101,1433,1173,73,68,0,5
101,1172,1206,99,67,0,32
101,1260,1356,73,49,1,24
101,1232,1191,53,43,1,10
101,1283,1434,66,55,1,11
101,1154,1441,100,86,1,14
101,1273,1359,87,59,1,28
101,1117,1204,62,58,1,4
101,1375,1102,80,72,1,8
101,1111,1102,67,60,1,7
101,1426,1407,86,91,1,-5
101,1125,1240,72,69,1,3
101,1287,1184,67,64,1,3
101,1258,1362,70,66,1,4
101,1334,1365,76,81,1,-5
101,1286,1170,77,75,0,2
101,1175,1288,67,92,0,-25
101,1290,1115,59,82,0,-23
101,1251,1391,77,64,1,13
101,1466,1195,96,81,1,15
1,1101,1190,70,47,1,23
1,1441,1423,98,76,1,22
1,1104,1240,81,57,0,24
1,1116,1290,142,62,0,80
1,1314,1158,79,60,0,19
1,1296,1227,61,65,0,-4
1,1354,1111,61,81,0,-20
1,1403,1322,101,58,0,43
1,1437,1130,76,67,1,9
1,1195,1197,65,56,0,9
1,1155,1280,53,42,1,11
1,1122,1303,72,66,1,6
1,1163,1148,102,75,0,27
1,1375,1194,68,66,0,2
1,1228,1299,122,60,0,62
1,1234,1300,97,67,0,30
1,1311,1413,101,93,1,8
1,1160,1377,84,61,1,23
1,1346,1192,84,66,0,18
1,1443,1320,93,87,1,6
1,1184,1316,80,67,1,13
1,1325,1152,84,61,1,23
1,1113,1348,94,88,1,6
1,1452,1355,79,71,1,8
2,1405,1324,80,53,1,27
2,1120,1386,96,91,1,5
2,1211,1242,102,90,1,12
2,1325,1299,84,72,1,12
2,1300,1380,85,78,1,7
2,1317,1290,116,62,0,54
2,1303,1292,60,59,1,1
2,1228,1152,97,38,0,59
2,1122,1190,67,66,1,1
2,1362,1406,79,68,1,11
2,1443,1272,75,69,1,6
2,1251,1280,84,73,1,11
2,1130,1348,69,64,1,5
2,1437,1113,83,74,1,9
3,1407,1441,66,64,1,2
3,1125,1206,77,67,1,10
3,1240,1194,60,50,1,10
3,1241,1313,73,83,0,-10
3,1133,1324,74,60,1,14
3,1350,1287,82,64,1,18
3,1184,1149,60,50,1,10
3,1179,1377,69,53,1,16
3,1353,1192,96,75,0,21
3,1190,1292,57,43,1,14
3,1362,1438,61,60,1,1
3,1101,1122,80,72,1,8
3,1150,1187,57,66,0,-9
3,1299,1152,74,44,1,30
3,1429,1320,82,71,1,11
3,1433,1272,70,59,1,11
4,1206,1224,84,70,1,14
4,1298,1291,73,67,1,6
4,1330,1456,86,78,0,8
4,1313,1347,57,54,1,3
4,1348,1378,84,68,1,16
4,1394,1402,63,75,0,-12
4,1426,1322,80,71,1,9
4,1450,1186,71,68,0,3
4,1252,1249,76,73,1,3
4,1461,1290,97,61,0,36
4,1132,1354,101,78,0,23
4,1119,1138,78,74,1,4
4,1439,1437,81,73,1,8
4,1369,1282,71,66,1,5
5,1256,1322,91,77,0,14
5,1375,1240,73,77,0,-4
5,1439,1378,76,58,1,18
5,1401,1309,82,53,0,29
5,1208,1197,85,75,0,10
5,1348,1362,84,71,1,13
5,1359,1105,76,78,0,-2
5,1376,1409,69,58,1,11
6,1400,1172,78,76,1,2
6,1231,1344,79,58,1,21
6,1111,1132,76,78,0,-2
6,1385,1130,97,93,1,4
6,1280,1402,68,51,0,17
6,1314,1424,78,51,1,27
6,1390,1104,82,64,1,18
6,1114,1182,76,66,1,10
6,1374,1394,91,54,0,37
6,1220,1192,73,58,0,15
7,1425,1140,79,53,1,26
7,1149,1299,63,70,0,-7
7,1304,1377,76,69,0,7
7,1400,1231,66,44,1,22
7,1314,1390,67,63,1,4
7,1415,1449,57,42,1,15
7,1457,1422,75,67,1,8
8,1313,1330,66,80,0,-14
8,1296,1188,53,73,0,-20
8,1369,1356,79,87,0,-8
8,1401,1470,73,66,0,7
8,1410,1394,62,59,0,3
8,1155,1354,75,38,0,37
8,1404,1191,93,87,0,6
8,1182,1422,81,68,1,13
8,1180,1346,66,48,1,18
8,1365,1167,53,47,0,6
8,1231,1390,79,63,1,16
8,1400,1314,69,67,1,2
8,1172,1424,77,73,1,4
9,1183,1152,78,56,0,22
9,1395,1322,74,68,0,6
9,1154,1299,78,70,0,8
9,1163,1425,61,58,1,3
9,1196,1130,90,70,1,20
9,1457,1114,80,75,1,5
10,1280,1317,69,63,0,6
10,1198,1240,74,70,0,4
10,1332,1371,83,70,1,13
10,1216,1148,80,65,0,15
11,1421,1354,77,56,0,21
11,1321,1152,111,66,0,45
11,1344,1192,79,67,0,12
11,1101,1470,69,48,0,21
11,1338,1296,89,59,0,30
11,1112,1186,70,67,0,3
11,1203,1164,85,69,0,16
11,1151,1297,79,72,0,7
11,1158,1202,57,81,0,-24
12,1401,1410,81,68,0,13
12,1322,1419,83,92,0,-9
13,1369,1252,82,77,0,5
13,1313,1214,76,64,0,12
13,1316,1194,77,79,0,-2
13,1150,1354,78,40,0,38
13,1332,1186,69,52,0,17
14,1280,1238,82,59,0,23
14,1192,1148,87,94,0,-7
14,1272,1290,94,57,0,37
14,1255,1299,77,60,0,17
14,1296,1123,70,79,0,-9
15,1158,1267,72,84,0,-12
15,1260,1152,88,51,0,37
15,1433,1299,95,59,0,36
15,1252,1369,80,74,0,6
15,1192,1148,79,71,0,8
15,1332,1197,87,66,0,21
15,1116,1380,79,44,0,35
16,1394,1410,64,68,0,-4
16,1315,1377,75,71,1,4
16,1164,1422,86,80,0,6
17,1150,1111,57,61,0,-4
17,1158,1354,90,63,0,27
17,1295,1377,74,67,1,7
17,1355,1315,74,62,1,12
17,1356,1293,70,66,0,4
18,1173,1280,85,82,1,3
18,1190,1412,61,65,0,-4
18,1328,1197,85,54,0,31
18,1395,1401,73,55,0,18
18,1403,1394,77,57,1,20
18,1299,1441,98,104,0,-6
18,1120,1272,74,71,1,3
18,1377,1355,91,78,1,13
18,1314,1300,73,67,0,6
19,1399,1240,67,73,0,-6
19,1234,1296,106,53,0,53
19,1435,1290,84,41,0,43
19,1354,1239,58,60,0,-2
19,1422,1313,64,47,0,17
19,1142,1363,73,71,0,2
19,1421,1219,90,84,0,6
20,1203,1456,84,85,0,-1
21,1428,1430,75,67,0,8
21,1418,1309,73,63,0,10
22,1419,1212,61,78,0,-17
22,1176,1294,75,83,0,-8
22,1408,1272,74,80,0,-6
22,1449,1285,58,66,0,-8
22,1333,1427,73,61,0,12
24,1428,1225,79,41,0,38
25,1211,1234,99,88,1,11
25,1345,1323,88,78,1,10
25,1379,1419,60,47,0,13
25,1176,1402,68,70,0,-2
25,1231,1139,68,60,1,8
25,1337,1364,63,75,0,-12
25,1150,1299,76,72,0,4
25,1178,1460,70,93,0,-23
25,1418,1270,75,65,0,10
25,1314,1246,75,63,1,12
25,1332,1339,80,41,0,39
26,1178,1460,72,85,0,-13
26,1160,1449,92,69,1,23
26,1362,1213,68,65,1,3
26,1222,1108,88,55,0,33
27,1402,1319,70,65,1,5
27,1283,1114,85,77,0,8
27,1450,1341,90,62,0,28
27,1272,1409,49,56,0,-7
27,1349,1309,73,62,0,11
28,1419,1256,57,68,0,-11
28,1427,1249,88,66,0,22
28,1339,1286,62,59,0,3
28,1299,1422,65,86,0,-21
28,1160,1213,74,64,1,10
28,1176,1319,65,68,0,-3
28,1203,1150,65,66,0,-1
28,1222,1396,76,50,0,26
28,1365,1161,57,70,0,-13
29,1231,1321,67,74,0,-7
32,1228,1231,69,60,0,9
32,1416,1222,54,63,0,-9
32,1178,1324,75,77,0,-2
33,1414,1364,75,56,0,19
33,1178,1324,80,83,0,-3
34,1414,1364,73,69,0,4
35,1409,1222,65,64,0,1
35,1272,1378,58,57,0,1
36,1370,1339,84,68,0,16
36,1200,1203,47,71,0,-24
36,1269,1206,92,93,0,-1
36,1231,1336,87,85,0,2
36,1395,1341,66,61,0,5
37,1225,1319,65,78,0,-13
37,1129,1363,106,54,1,52
37,1305,1307,68,54,1,14
37,1449,1112,53,80,0,-27
37,1417,1428,72,70,0,2
38,1419,1117,84,72,0,12
38,1418,1402,83,77,0,6
38,1364,1168,81,63,0,18
38,1114,1426,102,93,0,9
38,1349,1427,95,86,0,9
39,1225,1319,78,83,0,-5
39,1419,1117,62,55,0,7
39,1364,1168,65,61,0,4
39,1418,1402,59,71,0,-12
39,1377,1176,93,54,0,39
39,1372,1309,78,67,0,11
39,1203,1182,63,75,0,-12
39,1129,1363,87,86,1,1
39,1305,1307,84,74,1,10
39,1425,1428,64,46,0,18
39,1349,1427,84,69,0,15
39,1354,1299,86,97,0,-11
39,1114,1426,75,62,0,13
40,1377,1176,79,57,0,22
40,1374,1222,60,74,0,-14
40,1354,1299,66,73,0,-7
40,1203,1182,75,73,0,2
41,1231,1268,63,55,0,8
43,1146,1309,83,79,0,4
43,1222,1455,70,63,0,7
43,1429,1307,77,45,1,32
44,1381,1225,85,80,0,5
44,1458,1231,80,73,0,7
44,1383,1291,70,55,0,15
44,1390,1449,91,75,1,16
44,1362,1339,88,64,0,24
45,1419,1426,64,77,0,-13
45,1418,1114,66,64,0,2
45,1383,1291,67,55,0,12
45,1427,1317,70,77,0,-7
45,1429,1307,82,46,1,36
46,1381,1225,83,67,0,16
46,1427,1317,77,69,0,8
46,1167,1142,65,50,0,15
46,1419,1426,74,75,0,-1
46,1415,1218,70,68,0,2
46,1418,1114,76,78,0,-2
46,1339,1211,88,116,0,-28
46,1309,1230,86,64,0,22
46,1143,1449,84,78,0,6
46,1222,1408,71,50,0,21
46,1113,1425,64,73,0,-9
46,1428,1332,73,79,0,-6
47,1304,1231,76,84,0,-8
48,1428,1160,58,65,0,-7
48,1341,1411,73,67,0,6
50,1203,1433,77,84,0,-7
51,1339,1362,63,79,0,-16
51,1225,1294,54,74,0,-20
51,1231,1345,69,81,0,-12
51,1291,1467,77,57,0,20
51,1161,1363,90,57,1,33
51,1425,1449,95,68,0,27
51,1428,1390,79,65,0,14
52,1176,1331,84,88,0,-4
52,1178,1453,86,61,0,25
52,1117,1419,74,72,0,2
52,1426,1418,91,86,0,5
52,1364,1471,69,52,0,17
52,1114,1402,59,63,0,-4
52,1256,1427,77,66,0,11
52,1291,1467,63,52,0,11
53,1225,1294,61,75,0,-14
53,1364,1471,84,53,0,31
53,1256,1427,82,66,0,16
53,1337,1339,80,65,0,15
53,1358,1223,87,80,0,7
53,1117,1419,93,72,0,21
53,1426,1418,51,68,0,-17
53,1114,1402,56,67,0,-11
53,1309,1270,99,84,0,15
53,1428,1143,63,72,0,-9
53,1417,1449,81,76,0,5
53,1161,1363,88,61,1,27
53,1176,1331,82,91,0,-9
53,1178,1453,68,65,0,3
54,1203,1173,54,67,0,-13
54,1409,1272,58,57,0,1
54,1222,1416,75,58,0,17
55,1341,1212,59,50,0,9
57,1309,1394,87,68,0,19
57,1222,1409,86,59,0,27
57,1449,1160,84,80,0,4
58,1362,1365,73,50,1,23
58,1140,1339,95,67,0,28
58,1148,1291,57,67,0,-10
58,1234,1231,69,81,0,-12
58,1272,1455,72,52,0,20
58,1450,1428,56,71,0,-15
59,1295,1176,70,58,0,12
59,1324,1178,86,81,0,5
59,1419,1402,47,57,0,-10
59,1418,1117,81,68,0,13
59,1426,1114,59,66,0,-7
59,1169,1364,58,105,0,-47
59,1148,1291,65,64,0,1
59,1427,1379,70,64,0,6
60,1427,1379,78,72,0,6
60,1169,1364,66,80,0,-14
60,1419,1402,63,69,0,-6
60,1426,1114,66,61,0,5
60,1418,1117,77,74,0,3
60,1290,1341,31,77,0,-46
60,1339,1360,70,78,0,-8
60,1311,1309,86,62,0,24
60,1363,1307,83,71,1,12
60,1295,1176,84,58,0,26
60,1324,1178,72,82,0,-10
60,1396,1222,51,68,0,-17
61,1187,1272,53,80,0,-27
61,1231,1353,70,74,0,-4
61,1449,1428,83,79,0,4
62,1115,1341,56,73,0,-17
62,1339,1258,50,75,0,-25
63,1272,1374,76,72,0,4
64,1322,1309,81,73,0,8
65,1427,1431,86,79,0,7
65,1225,1451,56,81,0,-25
65,1374,1272,67,65,0,2
65,1408,1222,60,83,0,-23
66,1464,1178,75,78,0,-3
66,1413,1364,51,72,0,-21
66,1402,1418,60,62,0,-2
66,1114,1419,66,62,0,4
67,1225,1451,62,81,0,-19
67,1413,1364,86,89,0,-3
67,1402,1418,73,74,0,-1
67,1114,1419,65,49,0,16
67,1341,1105,79,57,0,22
67,1431,1427,69,51,0,18
67,1368,1309,79,73,0,6
67,1291,1357,58,61,0,-3
67,1160,1428,74,77,0,-3
67,1464,1178,72,77,0,-5
67,1299,1197,70,58,0,12
68,1222,1374,70,48,0,22
68,1291,1357,76,64,0,12
68,1449,1450,62,77,0,-15
68,1299,1197,67,65,0,2
69,1341,1106,87,63,0,24
69,1272,1416,96,69,0,27
70,1231,1228,71,75,0,-4
71,1272,1416,75,61,0,14
71,1187,1222,82,73,0,9
72,1225,1186,75,89,0,-14
72,1339,1140,60,105,0,-45
72,1428,1112,73,58,0,15
72,1333,1449,91,71,0,20
73,1176,1315,82,85,0,-3
73,1178,1236,82,72,0,10
73,1465,1308,85,75,1,10
73,1117,1418,95,87,0,8
73,1426,1419,63,56,0,7
73,1402,1114,57,47,0,10
73,1198,1427,80,87,0,-7
73,1254,1192,62,77,0,-15
73,1468,1239,71,56,0,15
73,1391,1252,73,68,0,5
74,1198,1427,47,90,0,-43
74,1117,1418,83,77,0,6
74,1426,1419,58,52,0,6
74,1402,1114,77,67,0,10
74,1186,1225,90,64,0,26
74,1272,1187,66,59,0,7
74,1176,1315,85,81,0,4
74,1178,1236,83,56,0,27
74,1332,1449,86,74,0,12
74,1339,1337,70,91,0,-21
74,1288,1175,74,69,0,5
75,1231,1234,67,65,0,2
78,1321,1231,76,79,0,-3
78,1378,1222,65,82,0,-17
79,1418,1419,66,72,0,-6
79,1226,1225,69,43,0,26
79,1291,1254,66,60,0,6
79,1143,1428,75,76,0,-1
79,1449,1425,54,69,0,-15
79,1334,1339,84,57,0,27
80,1156,1178,83,89,0,-6
80,1442,1176,75,69,0,6
80,1218,1364,50,59,0,-9
80,1427,1194,84,80,0,4
80,1291,1254,64,46,0,18
80,1117,1114,73,62,0,11
81,1427,1194,86,75,0,11
81,1226,1225,64,58,0,6
81,1218,1364,74,81,0,-7
81,1419,1418,72,88,0,-16
81,1114,1117,65,67,0,-2
81,1326,1231,78,59,0,19
81,1449,1417,61,64,0,-3
81,1156,1178,71,64,0,7
81,1442,1176,82,75,0,7
81,1390,1428,73,66,0,7
82,1179,1260,51,50,0,1
83,1450,1449,63,65,0,-2
83,1309,1372,79,89,0,-10
84,1291,1447,39,61,0,-22
85,1231,1278,82,72,0,10
85,1461,1307,83,74,1,9
85,1291,1447,55,57,0,-2
86,1340,1225,84,64,0,20
86,1333,1428,74,56,0,18
86,1449,1390,61,79,0,-18
86,1455,1222,68,63,0,5
87,1282,1176,68,57,0,11
87,1178,1352,85,74,0,11
87,1430,1308,69,66,1,3
87,1364,1167,71,66,0,5
87,1461,1307,79,67,1,12
88,1364,1167,63,44,0,19
88,1225,1340,40,71,0,-31
88,1339,1334,58,80,0,-22
88,1192,1291,76,71,0,5
88,1231,1277,71,78,0,-7
88,1449,1143,62,51,0,11
88,1282,1176,80,69,0,11
88,1178,1352,80,61,0,19
88,1197,1299,71,57,0,14
88,1332,1428,67,64,0,3
89,1222,1153,90,52,0,38
89,1192,1291,61,74,0,-13
89,1197,1299,63,70,0,-7
89,1203,1348,78,70,0,8
89,1419,1114,78,66,0,12
89,1411,1341,75,77,0,-2
90,1309,1146,88,63,0,25
90,1419,1114,68,64,0,4
90,1418,1426,76,74,0,2
91,1113,1449,97,64,0,33
91,1341,1115,72,56,0,16
92,1368,1270,91,95,0,-4
92,1353,1231,74,63,0,11
92,1272,1408,61,46,0,15
92,1394,1309,61,69,0,-8
92,1300,1299,63,79,0,-16
92,1206,1203,63,58,0,5
93,1384,1291,65,72,0,-7
93,1428,1417,61,76,0,-15
93,1113,1449,80,72,0,8
93,1178,1352,83,73,0,10
93,1341,1290,82,62,0,20
93,1222,1443,81,57,0,24
94,1176,1303,76,80,0,-4
94,1415,1364,68,72,0,-4
94,1402,1419,58,49,0,9
94,1114,1418,61,66,0,-5
94,1382,1203,88,41,0,47
94,1225,1286,74,69,0,5
94,1427,1412,57,64,0,-7
95,1427,1412,96,79,0,17
95,1415,1364,68,52,0,16
95,1402,1419,61,57,0,4
95,1114,1418,69,59,0,10
95,1105,1341,54,55,0,-1
95,1287,1125,89,82,0,7
95,1309,1311,101,105,0,-4
95,1231,1276,57,73,0,-16
95,1176,1303,76,80,0,-4
95,1355,1282,89,77,0,12
95,1112,1449,75,74,0,1
95,1428,1425,71,61,0,10
95,1299,1300,55,53,0,2
96,1153,1272,74,80,0,-6
96,1222,1378,98,52,0,46
96,1225,1286,61,71,0,-10
97,1106,1341,67,70,0,-3
97,1230,1309,72,88,0,-16
98,1277,1231,64,58,0,6
98,1297,1178,70,69,0,1
98,1378,1272,52,73,0,-21
99,1309,1322,92,83,0,9
99,1428,1333,70,75,0,-5
99,1386,1247,72,66,1,6
99,1203,1200,53,49,1,4
100,1341,1380,68,61,0,7
100,1356,1133,73,63,1,10
100,1391,1468,73,70,1,3
100,1195,1252,72,60,1,12
100,1365,1339,95,86,1,9
100,1182,1350,67,62,1,5
100,1206,1203,73,59,1,14
101,1364,1142,71,57,0,14
101,1375,1419,80,72,1,8
101,1111,1114,67,60,1,7
101,1407,1426,91,86,1,5
101,1365,1334,81,76,1,5
102,1286,1170,73,74,0,-1
102,1340,1381,54,73,0,-19
102,1413,1218,74,66,0,8
102,1253,1414,58,73,0,-15
102,1169,1415,65,66,0,-1
102,1364,1142,70,54,0,16
102,1212,1105,80,72,0,8
102,1238,1106,79,54,0,25
102,1341,1108,81,69,0,12
102,1411,1380,80,74,0,6
102,1322,1146,79,70,0,9
102,1314,1181,91,73,0,18
102,1101,1230,85,60,0,25
102,1323,1199,83,73,0,10
102,1257,1438,58,68,0,-10
102,1309,1368,81,76,0,5
102,1358,1372,59,64,0,-5
102,1471,1168,85,78,0,7
102,1270,1249,51,60,0,-9
102,1223,1394,70,94,0,-24
102,1326,1228,68,73,0,-5
102,1345,1231,67,58,0,9
102,1213,1430,74,64,0,10
102,1465,1370,79,76,0,3
102,1410,1470,58,69,0,-11
102,1278,1353,70,77,0,-7
102,1166,1139,93,73,0,20
102,1266,1462,66,59,0,7
102,1344,1437,54,52,0,2
102,1417,1425,63,64,0,-1
102,1163,1207,98,82,0,16
102,1469,1308,56,68,0,-12
102,1385,1371,81,71,0,10
102,1443,1330,60,57,0,3
102,1461,1424,80,69,0,11
102,1279,1435,56,46,0,10
102,1116,1401,87,80,0,7
102,1120,1280,78,71,0,7
102,1281,1261,80,86,0,-6
102,1246,1376,92,64,0,28
102,1452,1329,80,85,0,-5
102,1428,1113,98,59,0,39
102,1208,1104,79,89,0,-10
102,1190,1151,63,53,1,10
102,1189,1406,69,48,1,21
102,1243,1235,61,56,0,5
102,1456,1423,73,60,1,13
102,1440,1202,91,90,1,1
102,1201,1429,51,57,0,-6
102,1420,1262,77,79,0,-2
102,1248,1137,84,92,0,-8
102,1119,1110,89,66,0,23
102,1436,1216,65,71,0,-6
102,1355,1303,84,71,1,13
102,1377,1442,86,69,1,17
102,1155,1338,77,62,0,15
102,1298,1259,68,76,0,-8
102,1455,1378,80,63,0,17
102,1267,1150,75,66,0,9
102,1317,1412,61,65,0,-4
102,1136,1357,85,55,0,30
102,1159,1131,77,69,0,8
102,1447,1291,60,66,0,-6
102,1175,1288,82,75,0,7
102,1422,1154,80,72,1,8
102,1260,1232,65,49,1,16
102,1179,1283,71,69,1,2
102,1273,1459,62,61,1,1
102,1418,1375,79,68,1,11
102,1382,1387,71,53,1,18
102,1209,1117,71,68,1,3
102,1287,1125,86,71,1,15
102,1157,1407,86,68,1,18
102,1388,1258,52,47,1,5
102,1111,1402,76,73,1,3
102,1433,1172,64,52,0,12
102,1337,1365,78,70,1,8
103,1234,1458,77,73,0,4
103,1268,1336,61,66,0,-5
103,1277,1276,70,64,0,6
103,1187,1153,69,82,0,-13
103,1222,1272,67,64,0,3
103,1333,1332,67,80,0,-13
103,1397,1196,65,54,0,11
103,1220,1174,83,75,1,8
103,1124,1403,88,73,0,15
103,1331,1315,76,65,1,11
103,1395,1400,64,76,0,-12
103,1180,1158,80,75,1,5
103,1295,1282,69,65,1,4
103,1321,1304,79,78,0,1
103,1457,1144,80,53,0,27
103,1251,1466,79,75,1,4
103,1260,1179,75,65,1,10
103,1241,1189,71,72,0,-1
103,1422,1190,77,65,1,12
103,1318,1456,63,47,1,16
103,1209,1418,84,73,1,11
103,1273,1440,73,59,1,14
103,1111,1157,64,61,1,3
104,1156,1454,71,65,1,6
104,1324,1297,69,58,1,11
104,1351,1145,78,76,1,2
104,1211,1388,78,55,1,23
104,1140,1337,82,77,1,5
104,1189,1220,76,58,1,18
104,1331,1355,90,88,1,2
104,1422,1273,69,61,1,8
104,1111,1209,80,73,1,7
104,1180,1318,74,67,1,7
104,1295,1377,79,75,1,4
105,1274,1338,79,73,1,6
105,1181,1130,86,51,1,35
105,1233,1346,72,48,1,24
105,1253,1169,85,63,1,22
105,1368,1270,71,68,1,3
105,1136,1291,68,73,0,-5
105,1323,1448,80,77,1,3
105,1193,1264,59,58,1,1
105,1349,1379,61,52,1,9
105,1142,1168,87,82,1,5
105,1223,1230,80,68,1,12
105,1156,1324,80,69,1,11
105,1180,1189,63,56,1,7
105,1211,1140,88,78,1,10
105,1331,1295,75,72,1,3
106,1294,1170,90,83,1,7
106,1393,1301,89,68,1,21
106,1319,1340,77,66,1,11
106,1461,1363,111,80,1,31
106,1238,1115,74,62,1,12
106,1207,1266,68,49,1,19
106,1424,1102,80,52,0,28
106,1285,1225,69,64,1,5
106,1119,1259,63,67,0,-4
106,1139,1462,70,69,1,1
106,1427,1150,72,62,1,10
106,1201,1307,85,77,1,8
106,1159,1137,105,75,0,30
106,1177,1344,70,62,1,8
106,1194,1431,76,70,1,6
106,1341,1290,91,64,1,27
106,1113,1450,64,59,1,5
106,1278,1321,51,46,1,5
106,1243,1395,71,50,1,21
106,1435,1401,79,68,1,11
106,1428,1449,98,95,1,3
106,1336,1304,72,66,1,6
106,1328,1235,79,73,1,6
106,1143,1390,76,58,1,18
106,1317,1292,76,56,1,20
106,1274,1155,67,64,1,3
106,1233,1373,55,52,1,3
106,1309,1368,80,63,1,17
106,1181,1257,70,56,1,14
106,1349,1267,72,68,1,4
106,1193,1284,79,60,1,19
106,1249,1223,62,52,1,10
106,1314,1323,101,59,1,42
107,1405,1123,91,89,1,2
107,1325,1245,85,63,1,22
107,1138,1275,74,63,1,11
107,1103,1132,74,67,1,7
107,1371,1385,77,69,1,8
107,1411,1108,78,55,1,23
107,1286,1226,71,63,1,8
107,1413,1167,58,56,1,2
107,1305,1129,89,82,1,7
107,1288,1197,77,75,1,2
107,1370,1465,83,66,1,17
107,1310,1265,67,62,1,5
107,1313,1300,87,58,1,29
107,1212,1380,72,67,1,5
107,1308,1410,77,61,1,16
107,1415,1218,62,52,1,10
107,1268,1277,68,57,1,11
107,1329,1452,72,69,1,3
107,1280,1246,74,73,1,1
107,1378,1396,73,71,1,2
107,1408,1409,77,70,1,7
107,1333,1417,83,79,1,4
107,1353,1231,61,50,1,11
107,1281,1208,73,70,1,3
107,1416,1187,72,62,1,10
107,1279,1376,76,59,1,17
107,1400,1403,67,66,1,1
107,1389,1351,75,60,1,15
107,1364,1253,95,87,1,8
107,1414,1142,58,51,1,7
107,1438,1393,72,69,1,3
107,1207,1437,72,71,1,1
107,1381,1294,91,83,1,8
107,1326,1278,79,75,1,4
107,1210,1274,70,66,1,4
107,1196,1435,69,63,1,6
107,1124,1243,74,68,1,6
107,1332,1113,91,73,1,18
107,1361,1461,69,66,1,3
107,1322,1309,82,79,1,3
107,1166,1139,87,56,1,31
107,1443,1427,80,67,1,13
107,1242,1328,69,62,1,7
107,1412,1349,73,60,1,13
107,1186,1319,66,60,1,6
107,1425,1428,91,85,1,6
107,1458,1336,75,74,1,1
107,1314,1439,81,73,1,8
107,1249,1358,70,69,1,1
107,1163,1177,94,60,1,34
107,1424,1429,53,74,0,-21
107,1256,1194,75,69,1,6
107,1317,1330,61,55,1,6
107,1285,1451,80,75,1,5
107,1161,1201,72,62,1,10
107,1160,1143,61,58,1,3
108,1153,1374,74,71,1,3
108,1276,1268,79,66,1,13
108,1443,1412,64,60,1,4
108,1104,1280,85,48,1,37
108,1455,1378,68,67,1,1
108,1326,1345,87,78,1,9
108,1397,1196,78,66,1,12
108,1317,1256,54,48,1,6
108,1411,1238,84,81,1,3
108,1325,1405,87,80,1,7
108,1288,1164,82,61,1,21
108,1233,1310,70,64,1,6
108,1311,1322,88,76,1,12
108,1207,1371,66,58,1,8
108,1228,1353,90,68,1,22
108,1329,1124,83,74,1,9
108,1286,1381,80,77,1,3
108,1116,1281,70,64,1,6
108,1222,1408,77,52,1,25
108,1138,1103,81,74,1,7
108,1213,1370,81,47,1,34
108,1193,1389,52,47,1,5
108,1333,1332,75,64,1,11
108,1234,1458,62,57,1,5
108,1199,1314,69,66,1,3
108,1364,1413,71,55,1,16
108,1101,1249,93,71,1,22
108,1166,1163,59,56,1,3
108,1341,1212,75,63,1,12
108,1361,1305,77,70,1,7
108,1261,1279,76,73,1,3
108,1186,1285,78,50,1,28
108,1272,1416,70,62,1,8
108,1308,1430,78,62,1,16
108,1160,1425,72,70,1,2
108,1414,1415,78,61,1,17
108,1429,1161,62,50,1,12
109,1216,1262,64,50,0,14
109,1313,1288,71,63,1,8
109,1104,1397,73,68,1,5
109,1326,1276,68,67,1,1
109,1153,1455,60,59,1,1
109,1228,1234,82,71,1,11
109,1261,1116,78,71,1,7
109,1233,1193,60,51,1,9
109,1222,1272,76,74,1,2
109,1411,1341,80,61,1,19
109,1361,1429,68,57,1,11
109,1400,1329,91,86,1,5
109,1207,1166,73,48,1,25
109,1325,1138,84,69,1,15
109,1186,1286,65,55,1,10
109,1210,1199,80,75,1,5
109,1317,1443,61,57,1,4
109,1101,1311,79,45,1,34
109,1213,1308,74,56,1,18
109,1333,1160,70,68,1,2
109,1364,1414,79,63,1,16
110,1382,1433,74,65,1,9
110,1159,1259,85,72,0,13
110,1104,1261,80,79,1,1
110,1222,1153,91,54,1,37
110,1228,1326,91,88,1,3
